apparition	ghost	phantom
diddy	puffdaddy	puffy
augustus	caesaraugustus	gaiusoctavius
earth	globe	planetearth
frontman	leadvocalist	leadvocals
gallons	gallon	usgal
host	presenter	tvhost
mentalillness	psychiatricdisorders	psychiatricillness
distilledbeverage	liquor	spirits
cephas	peter	petrus
cheikh	shaikh	shaykh
dairycattle	dairycow
cardiacarrhythmias	dysrhythmia
handbag	purse
lbj	lyndonbainesjohnson
kingzheng	yingzheng
ab	bachelor
mommy	mum
faerie	fey
presidenttheodoreroosevelt	theodoreroosevelt
pepticulcerdisease	pepticulcer
spaceshuttleprogram	spaceshuttle
hungarians	magyars
headmaster	principal
feliscatus	housecat
floodmyth	flood
shortfilms	shortsubject
federalreserve	fed
migraineheadaches	migraine
madhatter	themadhatter
empirecity	newyork
complainant	plaintiff
audiocassette	compactcassette
castellano	spanishlanguage
attentiondeficitdisorder	attentiondeficithyperactivitydisorder
californiaangels	losangelesangels
adrenaline	epinephrine
georgegershwin	gershwin
athene	pallasathena
infantileparalysis	poliomyelitis
epilepticseizure	seizures
pennstate	pennsylvaniastateuniversity
whitsunday	whit
twintowers	worldtradecenter
americansouth	southernunitedstates
josephstalin	stalin
alcoholdependence	alcoholism
cop	policeofficer
schweiz	switzerland
angelus	twilight
omar	umar
mixingconsole	mixingdesk
universalcitystudios	universalstudios
rachmaninoff	rachmaninov
norwegianparliament	stortinget
itching	pruritus
iranianrevolution	islamicrevolution
nabataeans	nabatean
airdisaster	planecrash
ltyrosine	tyr
verizoncommunications	verizon
shortton	ton
generalelectric	ge
londonheathrowairport	londonheathrow
business	firm
paul	sirpaulmccartney
unitedstatesconstitution	usconstitution
microsoftcorporation	microsoft
reptiles	reptile
televisionadvertisement	televisioncommercial
plantae	plant
actionfilm	action
tedkennedy	ted
hog	sus
chicagotribune	tribune
causticsoda	lye
bowser	koopa
swedishlanguage	swedish
factory	manufactory
brucebanner	hulk
consumption	tuberculosis
mandal	taluk
canadianbroadcastingcorporation	cbc
netherlands	thenetherlands
dwighteisenhower	presidenteisenhower
inflammatoryboweldiseases	inflammatoryboweldisease
chapelhill	unc
elvis	theking
thessalonica	thessaloniki
edema	oedema
londonstockexchange	lse
pullover	sweater
televisionprogramme	televisionprogram
compoundmicroscope	opticalmicroscope
dancemusic	electronicdancemusic
76ers	sixers
newyorkpolicedepartment	nypd
greenvegetables	leafygreens
piracy	pirate
ohiostateuniversity	osu
analgesics	analgesic
huntervalley	hunter
f15eagle	mcdonnelldouglasf15eagle
ami	myocardialinfarction
lm	lumens
computerscience	cs
countylaois	leix
uav	unmannedaerialvehicle
mysteryfiction	mystery
divide	drainagedivide
pozsony	pressburg
arsenalfc	arsenalfootballclub
tiff	torontofilmfestival
percival	sirpercival
braintumor	braintumour
thiamine	vitaminb1
personalcomputers	personalcomputer
discoverychannel	thediscoverychannel
ushighways	usroutes
dog	domesticdog
bookingagent	talentagent
gaelic	scottishgaelic
claudiusptolemaeus	claudiusptolemy
coder	computerprogrammer
nachmanides	ramban
discjockey	dj
collegeradio	studentradio
diabetesmellitustype2	type2diabetes
mercury	quicksilver
chemicalmanufacturing	chemicals
coloncancer	colorectalcancer
asphalt	bitumen
sirwinstonchurchill	winstonchurchill
virgilio	virgil
sodapop	softdrink
adventistchurch	seventhdayadventistchurch
gatwickairport	londongatwick
medication	medicine
metropolitanopera	themet
openvms	vms
frenchhorn	horns
neurologicaldisease	neurologicaldisorder
davinci	leonardodavinci
bangla	bengali
mercedesbenzsuperdome	superdome
ak47	kalashnikov
khmerlanguage	khmer
ferriswheel	observationwheel
jewishnewyear	roshhashanah
slovene	slovenian
independenceday	july4th
victorrecords	victortalkingmachinecompany
benares	varanasi
noordbrabant	northbrabant
hendrix	jimmyjames
easterncampaign	greatpatrioticwar
kaiserwilhelmii	wilhelmii
alopecia	hairloss
songdynasty	southernsongdynasty
bipolardepression	bipolardisorder
aerialreconnaissance	reconnaissance
nevada	nev
westvirginia	wv
laptopcomputer	laptop
ekaterinburg	sverdlovsk
musclespasms	musclespasm
bronx	thebronx
proprietarysoftware	proprietary
celsius	degreescelsius
domestichorse	horse
tinwoodman	tinwoodsman
shakespeare	williamshakespeare
mathematics	maths
stonecoldsteveaustin	stonecold
austriahungary	austrohungarianempire
earlmountbatten	lordmountbatten
johannstraussii	strauss
queenelizabeth	thequeenmother
stereosound	stereo
firearm	gun
laolanguage	laotian
objectorientedprogramminglanguage	oop
eveningstar	venus
railtransport	railway
sleepaids	sleeplessness
liverpool	thereds
sqmiles	squaremiles
chilepepper	chile
italianrepublic	italia
newyorktimes	thenewyorktimes
glycerin	glycerol
cattle	cow
slovaklanguage	slovakian
gothicrevivalarchitecture	victoriangothic
fiberglass	fibreglass
mexicancuisine	mexicanfood
urinarytractinfection	uti
governmentcorruption	politicalcorruption
cestoda	tapeworm
earthsciences	geosciences
consulgeneral	consul
thomasbabingtonmacaulay	thomasmacaulay
agriculture	farming
conservatory	musicschool
ancientegyptian	egyptian
lemberg	lvov
mbyte	megabyte
councillor	councilmember
led	lightemittingdiode
unionpacificrailroad	unionpacific
nuclearenergy	nuclearpower
londonphilharmonicorchestra	lpo
dixielandjazz	neworleansjazz
pil	publicimagelimited
liviadrusilla	livia
eastersunday	easter
hb	hemoglobin
russiansfsr	russiansovietfederativesocialistrepublic
chaplin	charleschaplin
blazers	portlandtrailblazers
carbonatedwater	seltzer
washingtonwizards	wizards
abc	americanbroadcastingcompany
fainting	swooning
spine	vertebralcolumn
grandcentralstation	grandcentralterminal
crossoversuv	cuv
occitanlanguage	occitan
thomasaquinas	thomas
northernarmy	unionarmy
arthurconandoyle	sirarthurconandoyle
2012olympicgames	londonolympics
catstevens	yusuf
fortcrook	offuttairforcebase
valvecorporation	valve
filmproducer	producer
cloth	textile
acne	pimples
governmentschool	stateschool
hardy	oliverhardy
f16fightingfalcon	generaldynamicsf16fightingfalcon
mosesmaimonides	rambam
thes	timeshighereducation
losangeleslakers	minneapolislakers
samanidempire	samanid
bassguitarist	bassplayer
dnafingerprinting	dnaprofiling
galician	gallego
generalofficer	generals
gawain	sirgawain
crf	crh
newarkairport	newarklibertyinternationalairport
athlete	sportsman
michiganstate	msu
notoriousbig	thenotoriousbig
marriage	matrimony
americas	america
elijah	eliyahu
digestivesystem	gi
thedailymail	themail
elberiver	elbe
canadiannationalrailway	cnrail
belarusian	belorussian
elessar	strider
perspiration	sweating
zipcode	zip
september11attacks	september11
princessbeatrix	queenbeatrix
germanlanguage	german
ill	il
manxlanguage	manx
rangersfootballclub	rangers
jurchens	jurchen
duomo	florencecathedral
asteroidbelt	mainbelt
gent	ghent
allied	allies
polishlanguage	polish
supernes	supernintendoentertainmentsystem
pennsaukentownship	pennsauken
4000bc	4thmillenniumbc
ucl	universitycollegelondon
musicproducer	recordproducer
cigars	cigar
arrangements	arrangement
patrick	saintpatrick
cowmilk	milk
aztec	nahuatl
princesspeach	princesstoadstool
bostonglobe	thebostonglobe
poona	pune
pangaea	pangea
affairs	affair
humor	humour
grandduke	grandprince
grocerystores	grocerystore
johnlydon	johnnyrotten
barbecue	barbeque
bcs	bowlchampionshipseries
iata	internationalairtransportassociation
comedian	comedienne
zoroastrianism	zoroastrian
henrydavidthoreau	thoreau
ctvtelevisionnetwork	ctv
onions	onion
civilpartnership	civilunion
turnerbroadcastingsystem	turnerbroadcasting
erniewise	wise
aufdermaur	melissaaufdermaur
federaltradecommission	ftc
maritimeclimate	oceanicclimate
eglinafb	eglinairforcebase
antiviraldrug	antivirals
mst3k	mysterysciencetheater3000
flipflop	latch
fourseasons	thefourseasons
chat	onlinechat
audioengineer	soundengineer
conversiontherapy	reparativetherapy
avicenna	ibnsina
generalstaff	staff
dorpat	tartu
sardegna	sardinia
spinalcordinjury	spinalinjury
abcworldnewstonight	worldnewstonight
mohawklanguage	mohawk
jacobneusner	neusner
richardbachman	stephenking
benjaminthompson	countrumford
rodentia	rodent
steiermark	styria
maxplanckinstitute	maxplancksociety
beachboys	thebeachboys
exclamation	interjection
magneticresonanceimaging	mri
sbsone	sbstv
carbonates	carbonate
lucasarts	lucasfilmgames
janetjackson	janet
classicalpianist	pianist
mammals	mammal
channel5	channelfive
ernestrenan	renan
countrycodes	countrycode
firstindochinawar	indochinawar
coronationstreet	corrie
edwardsafb	edwardsairforcebase
beaubridges	beau
bfi	britishfilminstitute
royalshakespearecompany	rsc
cbsthismorning	theearlyshow
leader	theleader
mandela	nelsonmandela
iihf	internationalicehockeyfederation
calories	calorie
summertime	summer
catwoman	selinakyle
beetle	coleoptera
cochin	kochi
amnestyinternational	amnesty
ladymarywortleymontagu	marywortleymontagu
sardinianlanguage	sardinian
godard	jeanlucgodard
aum	om
exhibitiongame	friendlymatch
fiatcurrency	fiatmoney
enemies	enemy
userexperience	ux
megaplex	multiplex
jiverecords	jive
kaohsiungcity	kaohsiung
thasos	thassos
commissionedofficer	militaryofficer
basquelanguage	basque
magician	wizard
eccentricity	orbitaleccentricity
eff	electronicfrontierfoundation
startupcompany	startup
technomusic	techno
taranto	tarentum
archdiocese	diocese
mediumearthorbit	meo
breathing	breath
luddites	luddite
americanjews	jewishamerican
socialinteraction	socialrelations
ramsarconvention	ramsarsite
odin	wotan
sabc	southafricanbroadcastingcorporation
dowland	johndowland
americanmotorscorporation	americanmotors
publicbroadcasting	publicradio
yaleuniversity	yale
torino	turin
lehi	sterngang
ferdinandmagellan	magellan
herculepoirot	poirot
grigorirasputin	rasputin
mascagni	pietromascagni
vacciniavirus	vaccinia
bilbobaggins	bilbo
jacobites	jacobitism
irishpeople	irish
cascademountains	cascaderange
afp	agencefrancepresse
usattorney	unitedstatesattorney
laurel	stanlaurel
thewelltemperedclavier	welltemperedclavier
lotusdevelopmentcorporation	lotussoftware
lirr	longislandrailroad
easttimor	timorleste
multistoreycarpark	parkinggarage
troad	troas
charlesdegaulle	degaulle
northrhinewestphalia	nrw
shivering	shiver
emericpressburger	pressburger
casimirivjagiellon	casimir
realitytelevision	realitytv
babel	babylon
giacomopuccini	puccini
garonneriver	garonne
antisubmarinewarfare	asw
spawning	spawn
newyorkpost	thenewyorkpost
astronomicalunits	astronomicalunit
biasedsample	samplingbias
sufism	sufi
imaginarynumbers	imaginarynumber
strike	striking
bluenoterecords	bluenote
quay	wharf
atlantaconstitution	theatlantajournalconstitution
bernini	gianlorenzobernini
paine	thomaspaine
airconditioner	airconditioning
chinesemedicine	traditionalchinesemedicine
drugs	drug
connecticut	ct
coordination	gleichschaltung
rmstitanic	titanic
trees	tree
bdp	boogiedownproductions
vehicles	vehicle
brownbear	ursusarctos
tennesseevalleyauthority	tva
chineseceramics	chineseporcelain
mickjagger	mick
seattleinternationalfilmfestival	siff
albinoluciani	popejohnpauli
peninsularmalaysia	westmalaysia
degreesfahrenheit	fahrenheit
grainsize	particlesize
thickener	thickeningagent
elementaryeducation	primaryeducation
punjabilanguage	punjabi
astonvilla	villa
ptolemaicegypt	ptolemaickingdom
tirol	tyrol
checkers	draughts
leninism	leninist
bulimianervosa	bulimia
countyroscommon	roscommon
casanova	giacomocasanova
sneakers	sneaker
pda	personaldigitalassistant
bacchus	dionysus
repetitivestraininjury	rsi
nanjing	nanking
modestmussorgsky	mussorgsky
california	calif
hmmwv	humvee
derry	londonderry
thevandals	vandals
legalentity	legalpersonality
neurofibromatosis	nf
rsasecurity	rsa
bretonlanguage	breton
centreparty	zentrum
railtracks	track
racemicmixture	racemic
eastcarolinauniversity	ecu
larryfine	larry
nationalfootballleague	nfl
cusco	cuzco
blackcrowes	theblackcrowes
afrikaanslanguage	afrikaans
gallianarbonensis	transalpinegaul
psychokinesis	telekinesis
newinternationalversion	niv
americannationalstandardsinstitute	ansi
memorysegmentation	segmentation
uci	unioncyclisteinternationale
canadianprairies	prairies
georgsolti	sirgeorgsolti
oswaldmosley	siroswaldmosley
wrinkles	wrinkle
lagosstate	lagos
milkywaygalaxy	milkyway
maharishi	maharshi
hansarp	jeanarp
rnasplicing	splicing
phoenicians	phoenicia
echoawards	echo
pectins	pectin
japaneselanguage	japanese
indycar	irl
explosivematerial	explosive
mobiloil	mobil
cello	violoncello
jeanpaulsartre	sartre
squint	strabismus
eminem	marshallmathers
gongs	gong
hittiteempire	hittites
playstation3	ps3
benkenobi	obiwankenobi
joker	thejoker
eideticmemory	photographicmemory
panamericanworldairways	panam
northernlights	thegoldencompass
sampson	samson
babar	babur
adrianboult	siradrianboult
luxembourgcity	luxembourg
hydrochloricacid	muriaticacid
worcestercounty	worcester
arteriovenousmalformation	avm
signage	sign
princevijaya	vijaya
aphelion	perihelion
latraviata	violetta
uhf	ultrahighfrequency
orsonwelles	welles
operatingsystem	os
folkmusic	folk
ascorbate	vitaminc
hughlaurie	laurie
cpv	vietnamesecommunistparty
daffyduck	daffy
anorexianervosa	anorexia
britishindia	britishraj
annamaebullock	tinaturner
yawning	yawn
pakistanarmy	pakistaniarmy
financialindustryregulatoryauthority	finra
braunschweig	brunswick
unitedstatesmilitaryacademy	westpoint
confucianism	confucian
risperdal	risperidone
westinghouseelectriccorporation	westinghouseelectric
pretenders	thepretenders
thewombles	wombles
dowjonesindustrialaverage	dowjones
gebuilding	rcabuilding
cantos	thecantos
sfu	simonfraseruniversity
celebrity	tvpersonality
dubaiairport	dubaiinternationalairport
anglicanism	anglican
lagalaxy	losangelesgalaxy
christianrevival	revivalism
newjersey	nj
oleaeuropaea	olive
americanwest	westernunitedstates
bobweinstein	bob
browser	webbrowser
countytipperary	tipperary
myopia	nearsightedness
alphonsedaudet	daudet
borgqueen	borg
blackcat	felicia
acutemyeloidleukemia	aml
pequeninos	piggies
plasmaphysics	plasma
dwarves	thedwarves
conartist	conman
medievalperiod	middleages
grindcore	grind
mixedmartialarts	mma
peregrintook	pippin
rallyracing	rallying
edmondrostand	rostand
cadburyschweppes	cadbury
valleys	valley
easternwu	wu
pasteurisation	pasteurization
junkersju87	stuka
personalitydisorders	personalitydisorder
denvernuggets	nuggets
revenge	vengeance
akc	americankennelclub
sirthomasmore	thomasmore
princesssailormoon	sailormoon
dmitrishostakovich	shostakovich
c64	commodore64
benedictineorder	benedictine
taiwanesehokkien	taiwanese
losangelestimes	thelosangelestimes
fozziebear	fozzie
heraldsun	theherald
monopolies	monopoly
mosdef	mos
brynhildr	brynhild
neonazism	neonazi
ayersrock	uluru
hardwarestores	hardwarestore
diabeticketoacidosis	dka
medallion	medal
cactaceae	cactus
linkinpark	xero
latinvulgate	vulgate
cosmos	kosmos
albuquerque	alburquerque
highcholesterol	hypercholesterolemia
rajivgandhi	rajiv
crater	impactcrater
arthurcompton	arthurhollycompton
hurricaneirene	tropicalstormirene
arachnida	arachnid
greattribulation	tribulation
http	hypertexttransferprotocol
sneeze	sneezing
flanders	flemishregion
kansascityathletics	oaklandathletics
fontfamily	typeface
lascala	teatroallascala
rebamcentire	reba
sports	sport
dyspepsia	indigestion
executiveofficer	xo
baltimorecity	baltimore
boeing	theboeingcompany
billgaines	williamgaines
49ers	sanfrancisco49ers
initialpublicoffering	ipo
adrianople	edirne
nationalbroadcastingcompany	nbc
administrativecenter	administrativecentre
emperorhirohito	hirohito
khannooniensingh	khan
drafter	draughtsman
wallonia	walloonregion
creelanguage	cree
boils	boil
davidcameron	primeministerdavidcameron
portjackson	sydneyharbour
realtimestrategy	rts
rudolphgiuliani	rudygiuliani
flatulence	flatus
succinate	succinicacid
coach	headcoach
lesbianism	lesbian
americanrecordings	defamerican
lakemalawi	lakenyasa
osagenation	osage
diplopoda	millipede
teslas	tesla
ghostfacekillah	ghostface
plazahotel	theplaza
boxjellyfish	cubozoa
uzbeklanguage	uzbek
bonnaroomusicfestival	bonnaroo
metoffice	meteorologicaloffice
dishnetwork	dish
chinesecuisine	chinesefood
education	teaching
slits	theslits
labordayweekend	laborday
rastafarian	rastafari
alms	americanlemansseries
danniiminogue	dannii
networkadapter	networkcard
intrauterinedevice	iud
paulreubens	reubens
dacia	romandacia
edgarallanpoe	poe
greenpeaceinternational	greenpeace
sacagawea	sakakawea
walton	williamwalton
americans	american
kanagawaprefecture	kanagawa
giantpanda	panda
shawcommunications	shaw
internalrevenueservice	irs
fibonaccinumber	fibonaccisequence
ia	iowa
urinalysis	urinetest
transferrna	trna
ap	associatedpress
cellmembrane	plasmamembrane
aridclimate	desertclimate
globalpositioningsystem	gps
uthmanibnaffan	uthman
setswana	tswana
corea	korea
essays	theessays
sephardijews	sephardicjews
asianbritish	britishasian
msnmessenger	windowslivemessenger
majorleaguebaseball	mlb
mississippistatepenitentiary	parchman
smothersbrothers	thesmothersbrothers
attacker	striker
totalloss	totaled
stonetemplepilots	stp
harzmountains	harz
secureshell	ssh
dreamworksskg	dreamworks
arvn	southvietnamesearmy
phrygians	phrygia
sleeping	sleep
reims	rheims
jawaharlalnehru	nehru
cryptography	cryptology
alexanderpushkin	pushkin
ukrainiansovietsocialistrepublic	ukrainianssr
ebert	rogerebert
jacquesoffenbach	offenbach
heat	miamiheat
amiga	commodoreamiga
edgaraward	edgars
whiskey	whisky
naturalresources	naturalresource
ottomanarchitecture	ottoman
generaljameswolfe	jameswolfe
mekongriver	mekong
carlmariavonweber	weber
history	thehistorychannel
dprk	northkorea
destiny	fate
roughtraderecords	roughtrade
galanthus	snowdrop
epicfantasy	highfantasy
daffodil	narcissus
bertoltbrecht	brecht
henrywood	sirhenrywood
kashubianlanguage	kashubian
umno	unitedmalaysnationalorganisation
staxrecords	stax
aasho	aashto
bosch	robertboschgmbh
euclideangeometry	euclideanplane
chemicalweapons	chemicalweapon
mechanicalwork	work
cutlerbay	cutlerridge
thrace	westernthrace
palestinianauthority	palestiniannationalauthority
hannabarberaproductions	hannabarbera
highpriest	kohengadol
grandfunkrailroad	grandfunk
alhirschfeld	hirschfeld
iconium	konya
archies	thearchies
claudedebussy	debussy
hetfield	jameshetfield
socialsystems	socialsystem
devonshire	devon
phenylalanine	phe
medfordtownship	medford
f4phantomii	mcdonnelldouglasf4phantomii
stooges	thestooges
geestland	geest
experts	expert
augustarichmondcounty	augusta
fugees	thefugees
lakotapeople	lakotasioux
dominic	saintdominic
jainism	jain
allterrainvehicle	quad
menopausal	menopause
salvationarmy	thesalvationarmy
pergamon	pergamum
palaeography	paleography
vcd	videocd
massachusettsbaytransportationauthority	mbta
achaemeniddynasty	achaemenidempire
orinocoriver	orinoco
balochistan	baluchistan
standardcharteredbank	standardchartered
kingstontrio	thekingstontrio
tropicaldiseases	tropicaldisease
disulfides	disulfide
fiqh	islamicjurisprudence
laws	law
mililanitown	mililani
joemccarthy	josephmccarthy
radiomast	radiotower
riker	williamriker
filmproduction	filmmaking
phenylketonuria	pku
primenumber	prime
gleevec	imatinib
harveyweinstein	harvey
commodoreinternational	commodore
browncoal	lignite
dacca	dhaka
canallock	lock
leotolstoy	tolstoy
unitedstatesarmedforces	unitedstatesmilitary
sahrawipeople	sahrawi
epcotcenter	epcot
campground	campsite
absolutemajority	supermajority
militaryorganization	militaryunit
fortunemagazine	fortune
robotics	robot
jerome	saintjerome
greatesthitsalbum	greatesthits
gastriccancer	stomachcancer
orchestral	orchestra
bigblue	ibm
niu	northernillinoisuniversity
cardboard	corrugatedfiberboard
seineriver	seine
jewishpeople	jew
fis	internationalskifederation
romanianlanguage	romanian
hochunk	winnebago
advancedencryptionstandard	rijndael
emccorporation	emc
petermarkroget	roget
vestlandet	westernnorway
managementconsultant	managementconsulting
westerncapeprovince	westerncape
whitemanafb	whitemanairforcebase
rollingstonemagazine	rollingstone
normandylandings	operationneptune
latoyajackson	latoya
grainger	percygrainger
chaney	lonchaney
wyoming	wy
syrianarabrepublic	syria
beethoven	ludwigvanbeethoven
desktoppublishing	dtp
semiconductordevicefabrication	semiconductorfabrication
cleftlip	cleftpalate
commission	committee
englishlanguage	english
iaea	internationalatomicenergyagency
hannover	hanover
bingcrosby	bing
pakistanpeoplesparty	ppp
orthodoxy	orthodox
titans	titan
ladybirdlake	townlake
socialdemocracy	socialdemocrat
thevelvetunderground	velvetunderground
goldenrule	thegoldenrule
naturopathicmedicine	naturopathy
blissymbolics	blissymbols
digitaltelevision	dtv
baalhatanya	shneurzalman
landclaims	landclaim
santorini	thera
beijinguniversity	pekinguniversity
bobbywomack	bobby
coumadin	warfarin
spiketv	spike
teennick	then
bernardobertolucci	bernardo
dramaticpoetry	versedrama
rcarecords	rca
taxation	tax
santaclaus	santa
pentateuch	torah
codex	codices
rogerscentre	skydome
gaymarriage	samesexmarriage
losalamosnationallaboratory	losalamosscientificlaboratory
davidattenborough	sirdavidattenborough
catalanlanguage	catalan
siemensag	siemens
bi	businessintelligence
colonialism	colonial
mayormichaelbloomberg	michaelbloomberg
outerhebrides	westernisles
asphyxiation	asphyxia
stockholmcounty	stockholm
thiruvananthapuram	trivandrum
aristarecords	arista
ohiohighschoolathleticassociation	ohsaa
ukrainianparliament	verkhovnarada
djmuggs	muggs
artificialselection	selectivebreeding
kingmidas	midas
croatia	hrvatska
karlheinzstockhausen	stockhausen
hf	highfrequency
oggvorbis	vorbis
concerttour	concert
genomicimprinting	imprinting
ebroriver	ebro
contractures	contracture
arecaceae	palmtree
thirdworldwar	worldwariii
integratedservicesdigitalnetwork	isdn
blackpeople	black
alfredsisley	sisley
almaata	almaty
constitutionaldemocracy	liberaldemocracy
bhagavadgita	gita
handoff	handover
communities	community
missouri	mo
aichiprefecture	aichi
astronomicalobject	celestialobject
bach	johannsebastianbach
alienation	socialalienation
americanmusicawards	americanmusicaward
goethe	johannwolfgangvongoethe
callcenter	callcentre
pints	pint
anu	australiannationaluniversity
ribosomalrna	rrna
gdp	grossdomesticproduct
hypochondriasis	hypochondria
cars	thecars
prague	praha
greekmacedonia	macedonia
feminism	feminist
kurdishlanguage	kurdish
chiefoperatingofficer	coo
spiritualsequel	spiritualsuccessor
fontane	theodorfontane
bayonets	bayonet
internetarchive	theinternetarchive
hollandia	jayapura
firstladymichelleobama	michelleobama
searstower	willistower
masterstournament	themasters
intergovernmentalorganization	intergovernmental
australiancricketboard	cricketaustralia
witchcraft	witch
robertmenzies	sirrobertmenzies
cordwainerbird	harlanellison
chelseafc	chelsea
newmexico	nm
sulfides	sulfide
electricalengineering	electricalengineer
nanometer	nanometre
blofeld	ernststavroblofeld
lupus	systemiclupuserythematosus
quine	willardvanormanquine
diggers	excavator
basicprogramminglanguage	basic
cn	copernicium
corneille	pierrecorneille
sc	southcarolina
gpu	graphicsprocessingunit
davidfincher	fincher
shimla	simla
financialstatements	financialstatement
faiyum	fayyum
ironmaiden	maiden
cavaliers	cavalier
royalphilharmonicorchestra	royalphilharmonic
qmjhl	quebecmajorjuniorhockeyleague
tornado	twister
timemagazine	time
fungi	fungus
fluoride	fluorine
ilprincipe	theprince
judgement	judgment
marcusantonius	markantony
himalayas	himalaya
su	syracuseuniversity
gurugranthsahib	srigurugranthsahib
arthurhonegger	honegger
ifc	internationalfinancecorporation
bernhardt	sarahbernhardt
athlon	k7
anaemia	anemia
scrubland	shrubland
sanpeople	san
bart	bayarearapidtransit
moehoward	moe
jonpertwee	pertwee
fungalinfections	fungalinfection
mormonism	mormon
digitalmillenniumcopyrightact	dmca
darkhorsecomics	darkhorse
beckenbauer	franzbeckenbauer
dobrudja	dobruja
nikolairimskykorsakov	rimskykorsakov
curriculumvitae	cv
ifrs	internationalfinancialreportingstandards
faz	frankfurterallgemeinezeitung
medevac	medicalevacuation
papiamento	papiamentu
denguefever	dengue
attleborough	attleboro
interpersonalrelationship	relationships
thewhitestripes	whitestripes
pdf	portabledocumentformat
pannonianbasin	pannonianplain
computerprinter	printer
blackholes	blackhole
messiaen	oliviermessiaen
hinterlands	hinterland
f104starfighter	lockheedf104starfighter
barcelona	fcbarcelona
gaga	ladygaga
monosodiumglutamate	msg
lawrencelivermorenationallaboratory	llnl
sundancefilmfestival	sundance
richardrodgers	rodgers
robinsafb	robinsairforcebase
paoloveronese	veronese
isakdinesen	karenblixen
amphibians	amphibian
intubation	trachealintubation
fe	iron
rensselaerpolytechnicinstitute	rpi
remains	theremains
relaxationtime	relaxation
lapd	losangelespolicedepartment
postmodernarchitecture	postmodern
sanfranciscointernationalairport	sfo
acrylicpaint	acrylic
transworldairlines	twa
minicooper	mini
humansociety	society
lakotalanguage	lakota
roseannebarr	roseanne
totalqualitymanagement	tqm
abbott	budabbott
australianoutback	outback
faboideae	papilionoideae
klia	kualalumpurinternationalairport
interprocesscommunication	ipc
adenosinetriphosphate	atp
humanskincolor	skinpigmentation
xeroxcorporation	xerox
pdb	proteindatabank
lastjudgement	lastjudgment
nationalgeographicmagazine	nationalgeographic
hdtv	highdefinitiontelevision
sixnationschampionship	sixnations
fracking	hydraulicfracturing
dukeuniversity	duke
alexainternet	alexa
internationaltelecommunicationunion	itu
biopiracy	bioprospecting
paramahansayogananda	yogananda
widereceiver	wr
herodantipas	herod
glinka	mikhailglinka
kinks	thekinks
fulbrightscholarship	fulbrightscholar
barisannasional	bn
doublepneumonia	pneumonia
microsoftoutlook	outlook
losangelesphilharmonicorchestra	losangelesphilharmonic
imap	internetmessageaccessprotocol
novonikolayevsk	novosibirsk
aquariums	aquarium
fusedquartz	fusedsilica
carlnielsen	nielsen
spinmagazine	spin
microwaveoven	microwave
berlioz	hectorberlioz
marxbrothers	themarxbrothers
utopias	utopia
ebenezerscrooge	scrooge
wipo	worldintellectualpropertyorganization
dailyexpress	sundayexpress
jeanplaidy	victoriaholt
bostonherald	thebostonherald
uncialscript	uncial
ceylon	srilanka
nebraska	ne
droitwichspa	droitwich
plasmatics	theplasmatics
seanlennon	sean
monosaccharides	monosaccharide
englishsetter	laverack
oldprussian	prussian
petrarchansonnet	petrarchan
imf	internationalmonetaryfund
kingjamesbible	kingjamesversion
dutcheastindiacompany	voc
epitaphrecords	epitaph
dardanelles	hellespont
professor	universityprofessor
hallmarkcards	hallmark
kilimanjaro	mountkilimanjaro
licenseplates	numberplate
eidaladha	eiduladha
tempest	thetempest
cascadingstylesheets	css
daponte	lorenzodaponte
bnl	brookhavennationallaboratory
plebiscite	referendum
diseases	disease
straycats	thestraycats
salah	salat
citigroup	citi
dallasarearapidtransit	dart
mauriceravel	ravel
scalablevectorgraphics	svg
bellcanada	bell
katangaprovince	katanga
repertorytheatre	repertory
ccir	itur
henrypurcell	purcell
josquindesprez	josquin
tisa	tisza
adm	archerdanielsmidland
nationalcancerinstitute	nci
nederlandsespoorwegen	ns
gemstone	gem
stadholder	stadtholder
longhilltownship	longhill
fafner	fafnir
theweb	worldwideweb
jeangrey	marvelgirl
guncrime	gunviolence
wrightpattersonafb	wrightpattersonairforcebase
osho	rajneesh
baroda	vadodara
southcentrallosangeles	southlosangeles
ponds	pond
chechenrepublic	chechnya
greenlandic	kalaallisut
sererpeople	serer
wbc	worldboxingcouncil
ambientmusic	ambient
electronicinstruments	electronicmusicalinstrument
phoenixsuns	suns
antenna	radioantenna
antoniovivaldi	vivaldi
danuberiver	danube
alberteinstein	einstein
electronicengineering	electronicsengineering
artbrut	outsiderart
roskosmos	russianfederalspaceagency
dizzygillespie	dizzy
macedonianlanguage	macedonian
carmelbythesea	carmel
justinmartyr	justin
judicialsystem	judiciary
russianorthodoxchurch	russianorthodox
radnorshire	radnor
johnjones	martianmanhunter
juilliardschool	juilliard
commune	municipality
aoltimewarner	timewarner
gaulishlanguage	gaulish
edoperiod	tokugawaperiod
classconflict	classstruggle
bms	bristolmyerssquibb
antonwebern	webern
frege	gottlobfrege
lancelot	sirlancelot
alfreddemusset	musset
antonym	opposites
smallbowel	smallintestine
televisionnetwork	tvnetwork
alecdouglashome	siralecdouglashome
charleslutwidgedodgson	lewiscarroll
landlockedcountry	landlocked
admiralnimitz	chesternimitz
afc	americanfootballconference
sids	suddeninfantdeathsyndrome
violins	violin
hafez	hafiz
pricewaterhousecoopers	pwc
vegetariancuisine	vegetarianfood
electricityconsumption	powerconsumption
epoch	j2000
death	deceased
bopomofo	zhuyin
reconquest	reconquista
carrots	carrot
heatconduction	thermalconduction
dellcomputer	dell
fordmotorcompany	ford
trabzon	trebizond
majapahitempire	majapahit
irreversibility	irreversibleprocess
bloombergbusinessweek	businessweek
medicalultrasonography	ultrasonography
mustela	weasel
mishnah	mishna
bobbydrake	iceman
greenarrow	oliverqueen
augusteescoffier	escoffier
nationaltransportationsafetyboard	ntsb
scotchwhisky	scotch
farm	taxfarming
dunsscotus	johndunsscotus
copper	cu
amartyasen	sen
insuranceagent	insurancebroker
jesuits	jesuit
tigrigna	tigrinya
kibibyte	kib
ya	youngadultliterature
nipponprofessionalbaseball	npb
jewellery	jewelry
experimentalmedicine	medicalresearch
arbitrariness	arbitrary
cyclops	scottsummers
bostonceltics	celtics
2lt	secondlieutenant
alecbaldwin	alec
eriksatie	satie
panicattacks	panicattack
anfieldroad	anfield
disneylandpark	disneyland
moscowstateuniversity	moscowuniversity
edvardgrieg	grieg
vab	vehicleassemblybuilding
kl	kualalumpur
dieselmultipleunit	dmu
captainnemo	nemo
countykerry	kerry
pilsner	pils
aquaman	orin
humanurine	urine
independentrecordlabel	independent
britishrailways	britishrail
madamabutterfly	madamebutterfly
colon	largeintestine
frodobaggins	frodo
ducks	duck
generalgeorgemarshall	georgemarshall
huntingtonlibrary	thehuntington
koreanconflict	koreanwar
britain	greatbritain
viennaphilharmonicorchestra	viennaphilharmonic
johnentwistle	theox
un	unitednations
frg	westgermany
dickcheney	vicepresidentdickcheney
harbor	harbour
nanjingmassacre	nankingmassacre
base	radix
menuet	minuet
batavia	jakarta
barber	samuelbarber
furlongs	furlong
madamechiang	soongmayling
bloodymary	marytudor
lordvishnu	vishnu
concordiauniversity	sirgeorgewilliamsuniversity
breeders	thebreeders
serbianlanguage	serbian
robertsmirke	sirrobertsmirke
sheffieldwednesday	theowls
bytes	byte
gelatine	gelatin
pacificcoastleague	pcl
freddiemercury	freddie
hibernian	hibs
suicidaltendencies	suicidal
pacifictimezone	pst
quarts	quart
chevrolet	chevy
ascomycetes	ascomycota
bondibeach	bondi
percentage	percent
choaterosemaryhall	choate
cornelluniversity	cornell
alfranken	franken
dukas	pauldukas
vistulariver	vistula
cemetery	graveyard
richtextformat	rtf
hindustaniclassicalmusic	hindustanimusic
alexanderii	emperoralexanderii
centrenationaldelarecherchescientifique	cnrs
mmhg	torr
firefox	mozillafirefox
developer	softwaredeveloper
elephants	elephant
omega3fattyacids	omega3fattyacid
pohnpei	ponape
bird	charlieparker
hofburgpalace	hofburg
pingpong	tabletennis
buenavistahomeentertainment	waltdisneystudioshomeentertainment
misfits	themisfits
apachesoftwarefoundation	asf
sulfate	sulphate
raaf	royalaustralianairforce
octaviaminor	octavia
mashad	mashhad
highercriticism	historicalcriticism
talcumpowder	talc
saragossa	zaragoza
nauticalmiles	nauticalmile
sakharepublic	yakutia
w3c	worldwidewebconsortium
jeffersonstarship	starship
gramophonerecord	vinylrecord
hertfordshire	herts
nb	newbrunswick
sadomasochism	sm
federalemergencymanagementagency	fema
alcs	americanleaguechampionshipseries
lutheranism	lutheran
nationalleaguechampionshipseries	nlcs
johnlocke	locke
canyon	gorge
melissajoanhart	melissa
thirteen	wnet
williamewartgladstone	williamgladstone
arlecchino	harlequin
regionalorganizations	regionalorganization
countylongford	longford
autoracing	automobileracing
fiume	rijeka
audiencia	realaudiencia
originalvideoanimation	ova
da	dopamine
pregnancy	pregnant
calvary	golgotha
realestateagent	realestatebroker
kristiania	oslo
boisestateuniversity	bsu
baptists	baptist
bruneidarussalam	brunei
ryuichisakamoto	sakamoto
plainsindians	plains
madeiraislands	madeira
pentecostalism	pentecostal
d66	democrats66
middleeasterncuisine	middleeastern
ba	britishairways
gravitationalslingshot	gravityassist
ariosto	ludovicoariosto
socialsecurityact	socialsecurity
shigaprefecture	shiga
acetylcholine	ach
homedepot	thehomedepot
melody	tune
succoth	sukkot
parasite	parasitism
echinodermata	echinoderm
quadraphonicsound	quadraphonic
pharmaceuticalindustry	pharmaceutical
scoobydoo	scooby
yamaguchiprefecture	yamaguchi
mortimerwheeler	sirmortimerwheeler
zoonoses	zoonosis
cme	coronalmassejection
carnegiemellonuniversity	cmu
byrds	thebyrds
guinevere	queenguinevere
corse	corsica
clinteastwood	clint
blackforest	schwarzwald
serbocroatianlanguage	serbocroatian
hippopotamus	hippo
burma	myanmar
vienna	wien
lightingdesigner	lightingdesign
geordilaforge	geordi
vintner	winemaker
principalskinner	seymourskinner
westlandaircraft	westland
hamlet	princehamlet
bl	yaoi
apartmentbuilding	apartment
mozart	wolfgangamadeusmozart
ipman	yipman
campidoglio	capitolinehill
countymeath	meath
croatiandemocraticunion	hdz
demons	melbournefootballclub
clemsonuniversity	clemson
tpgcapital	tpg
killerwhale	orca
anglocatholicism	anglocatholic
buddhahood	buddha
cityclerk	clerk
philadelphia	philly
annelida	annelid
mondaynightraw	wweraw
nationalrifleassociation	nra
freia	freyja
tatarlanguage	tatar
buddhism	buddhist
muscogee	muskogee
ziggymarley	ziggy
eastasia	easternasia
stacykeach	stacy
gynaecology	gynecology
clash	theclash
automotive	car
bigbopper	thebigbopper
greatreformact	reformact1832
newyorkstockexchange	nyse
haemophilia	hemophilia
cyprinidae	cyprinids
jewishchristians	jewishchristian
garbo	gretagarbo
kalmarcounty	kalmar
lowersaxony	niedersachsen
computationalscience	scientificcomputing
solarhotwater	solarwaterheating
lakedistrictnationalpark	lakedistrict
diabetesmellitustype1	type1diabetes
liliaceae	lilyfamily
unsecuritycouncil	unitednationssecuritycouncil
trafficcongestion	trafficjam
premiere	skydeutschland
passeri	songbird
nassauintercountyexpress	nice
peloponnese	peloponnesus
harrowschool	harrow
recall	recollection
colonelbogeymarch	colonelbogey
cellbiology	cytology
gioachinorossini	rossini
pine	pinus
constable	policeconstable
eukaryota	eukaryote
madmagazine	mad
malayalamlanguage	malayalam
commonfig	figs
generalomarbradley	omarbradley
americaonline	aol
emacs	gnuemacs
flu	influenza
bombay	mumbai
manganese	mn
diegomaradona	maradona
tulipa	tulip
breastmilk	humanmilk
lida	lyda
boccaccio	giovanniboccaccio
finzi	geraldfinzi
honeybee	honeybees
spreeriver	spree
nitroglycerine	nitroglycerin
hides	hide
bourbonwhiskey	bourbon
emmerdalefarm	emmerdale
apricots	apricot
securityguard	securityofficer
babydoc	jeanclaudeduvalier
theater	theatre
giuseppeverdi	verdi
cbs	columbiabroadcastingsystem
ammonia	anhydrousammonia
theundertones	undertones
applecomputers	appleinc
bavaria	bayern
salix	willow
cablenewsnetwork	cnn
euroamerican	europeanamerican
deputypresident	vicepresident
candidiasis	yeastinfection
kilobytes	kilobyte
antisocialbehaviour	antisocialbehavior
chekov	pavelchekov
veronicalodge	veronica
targetcorporation	target
champaignurbana	champaign
oxidation	redox
france	frenchrepublic
respiratorydiseases	respiratorydisease
whoi	woodsholeoceanographicinstitution
cronus	kronos
bronchialpneumonia	bronchopneumonia
kandinsky	wassilykandinsky
delays	thedelays
deutschebahnag	deutschebahn
hotelmanager	hotelier
generaldynamicscorporation	generaldynamics
dundeecity	dundee
navarra	navarre
digitalsignalprocessing	dsp
ala	americanlibraryassociation
zarathustra	zoroaster
juancarlos	kingjuancarlosi
indiclanguages	indoaryanlanguages
andrewlloydwebber	lloydwebber
colorblindness	colourblindness
delhi	nationalcapitalterritory
pallavadynasty	pallava
hemorrhoids	hemorrhoid
carlossantana	santana
baroquearchitecture	baroque
africannationalcongress	anc
unfpa	unitednationspopulationfund
glitterband	theglitterband
alabama	al
okehrecords	okeh
merano	meran
decibels	decibel
jeanpierrerampal	rampal
peterkember	sonicboom
barrygibb	barry
archives	archive
bonzodogband	bonzodogdoodahband
andalucia	andalusia
huldrychzwingli	ulrichzwingli
londonstanstedairport	stansted
trotskyism	trotskyist
sumerianlanguage	sumerian
communications	communication
abraham	ibrahim
vivendiuniversal	vivendi
johnkerry	senatorjohnkerry
travelagencies	travelagency
democraticnationalcommittee	dnc
chieftechnologyofficer	cto
southernfootballleague	southernleague
fielding	henryfielding
dinosauria	dinosaur
deathcult	thecult
madhuridixit	madhuri
busoni	ferrucciobusoni
cramps	thecramps
tagaloglanguage	tagalog
adobephotoshop	photoshop
netscapecommunicationscorporation	netscape
ld50	medianlethaldose
nileriver	nile
diatomicmolecule	diatomic
ernesthemingway	hemingway
casas	coleophora
chordata	chordate
vb	visualbasic
charlesives	ives
supportvectormachine	svm
helianthusannuus	sunflowers
dippydawg	goofy
newgeneralcatalogue	ngc
joelieberman	josephlieberman
gameshownetwork	gsn
deutschlandlied	germannationalanthem
ucsantacruz	ucsc
alger	algiers
mainriver	main
compliance	regulatorycompliance
edge	theedge
borderlinepersonalitydisorder	bpd
solo	surakarta
corfu	kerkyra
reliefpitcher	reliever
yevgenyzamyatin	zamyatin
johannpachelbel	pachelbel
internationalolympiccommittee	ioc
thomasalvaedison	thomasedison
chilipeppers	redhotchilipeppers
pixies	thepixies
character	fictionalcharacter
cherubini	luigicherubini
baleenwhale	mysticeti
bananas	banana
hour	hrs
augustopinochet	pinochet
homeshoppingnetwork	hsn
freefrance	freefrenchforces
pcr	polymerasechainreaction
wikimarkup	wikitext
aeronauticalengineering	aerospaceengineering
judygarland	judy
kiwifruit	kiwi
dfb	germanfootballassociation
akvavit	aquavit
bunny	rabbit
pahs	polycyclicaromatichydrocarbons
durante	jimmydurante
cosmicinflation	inflation
dlc	downloadablecontent
nationalcollegiateathleticassociation	ncaa
gloriaestefan	miamisoundmachine
thyroidgland	thyroid
romanesquearchitecture	romanesque
ermine	stoat
drusilla	dru
reggiemantle	reggie
wages	wage
aramaiclanguage	aramaic
jonnygreenwood	jonny
uniformresourcelocator	url
maasai	maa
manhattan	newyorkcounty
isleybrothers	theisleybrothers
coffeeshop	coffeehouse
domesticviolence	spousalabuse
aeneid	theaeneid
catty	jin
frenchsocialistparty	socialistparty
stalinism	stalinist
owl	webontologylanguage
originaldixielandjassband	originaldixielandjazzband
double	thedouble
m4sherman	shermantank
td	touchdown
bloodclot	thrombus
cervantes	migueldecervantes
madge	madonna
countywestmeath	westmeath
newmusicalexpress	nme
rudolphvalentino	valentino
greekrevivalarchitecture	greekrevival
paediatrics	pediatrics
buckminsterfullerene	buckyball
pashtolanguage	pashto
detroitredwings	redwings
af	atrialfibrillation
maxgoof	max
bowie	davidbowie
internationalspacestation	iss
hartmemorialtrophy	harttrophy
guangdongprovince	guangdong
tinytoonadventures	tinytoons
handgun	pistol
lenape	lennilenape
mankind	mickfoley
nationaltheatre	royalnationaltheatre
imperialrussia	russianempire
appletree	apple
gothicarchitecture	gothic
bittorrent	torrent
cambridgeuniversity	cambridge
zombies	zombie
erectiledysfunction	impotence
bronchodilators	bronchodilator
immunesuppression	immunosuppression
priondisease	tse
detective	policedetective
monatomicgas	monatomic
ltryptophan	tryptophan
chairs	chair
odyssey	theodyssey
ultimatefrisbee	ultimate
yazoo	yaz
bostonuniversity	bu
floridamarlins	miamimarlins
adamopelag	opel
douroriver	douro
poland	polska
joshuareynolds	sirjoshuareynolds
hectares	hectare
nbcsymphonyorchestra	nbcsymphony
sweet	thesweet
simontemplar	thesaint
tennessee	tn
guadalquivirriver	guadalquivir
geraldorivera	geraldo
alp	australianlaborparty
elmcity	newhaven
ringostarr	ringo
georgwilhelmfriedrichhegel	hegel
theyardbirds	yardbirds
isopropanol	isopropylalcohol
denisdiderot	diderot
nigellalawson	nigella
mandatepalestine	mandatorypalestine
gnulessergeneralpubliclicense	lgpl
totalsa	total
insanity	madness
husky	siberianhusky
ucsandiego	ucsd
sidjames	sidneyjames
falseetymology	folketymology
jamesdean	jimmydean
turntablism	turntablist
marywollstonecraft	wollstonecraft
symbols	symbol
a500	amiga500
microscopicscale	microscopic
alghazali	algazel
danielhandler	lemonysnicket
kinneret	laketiberias
ethers	ether
faeroeislands	faroeislands
treyanastasio	trey
gameboyadvance	gba
gaul	romangaul
kareemabduljabbar	lewalcindor
episcopalchurch	protestantepiscopalchurch
williamwordsworth	wordsworth
arcminutes	arcminute
ernestshackleton	sirernestshackleton
matchgame	thematchgame
socialisation	socialization
avedon	richardavedon
cervidae	deer
apulia	puglia
continents	continent
antidepressants	antidepressant
merovingiandynasty	merovingian
ethnicgroup	ethnicity
tacticalstudiesrules	tsr
neurodegeneration	neurodegenerativedisease
drugtrafficking	illegaldrugtrade
haddontownship	westmont
zinc	zn
buggles	thebuggles
annettefunicello	annette
irishnavalservice	navalservice
oriental	orient
bagpipes	bagpipe
cincinnati	queencity
mithraicmysteries	mithraism
maggiesimpson	maggie
jeangiraud	moebius
internetrelaychat	ircclient
heritagefoundation	theheritagefoundation
ralphrichardson	sirralphrichardson
upperdublintownship	upperdublin
musclecontractions	musclecontraction
buildingconstruction	construction
injuries	injury
thetrojanwomen	trojanwomen
militaryhelicopters	militaryhelicopter
commons	thecommons
urate	uricacid
swans	sydneyswans
apparel	clothing
johnxii	popejohnxii
leiden	leyden
altcountry	alternativecountry
balkanmountains	staraplanina
preeclampsia	toxemia
saintsebastian	sebastian
horowitz	vladimirhorowitz
partygames	partygame
memorabilia	souvenir
elektrarecords	elektra
mins	minute
psychosis	psychoticdisorders
lycra	spandex
malmstromafb	malmstromairforcebase
gnss	satellitenavigation
yleisradio	yle
apiculture	beekeeping
stevevanzandt	stevenvanzandt
arminianism	arminian
buffalobillcody	buffalobill
zululanguage	zulu
couch	sofa
scifichannel	syfy
quantitative	quantity
naturalhistorymuseum	thenaturalhistorymuseum
oglalalakota	oglala
hypodermis	subcutaneoustissue
sydneycbd	sydneycentralbusinessdistrict
sicilia	sicily
eielsonafb	eielsonairforcebase
mycenaeangreece	mycenaeanperiod
cube	icecube
germanmeasles	rubella
capsize	capsizing
vampires	vampire
kingdom	monarchy
stettin	szczecin
harvarduniversity	harvard
conferencecentre	conventioncenter
karlovyvary	karlsbad
storm	thunderstorm
neurolinguisticprogramming	nlp
severussnape	snape
rfu	rugbyfootballunion
securesocketslayer	transportlayersecurity
computersciencescorporation	csc
uncharter	unitednationscharter
dantealighieri	dante
brussels	bruxelles
latifah	queenlatifah
yukonterritory	yukon
avrillavigne	avril
bayerag	bayer
radiofranceinternationale	rfi
meatballs	meatball
boleynground	uptonpark
netassets	networth
neilpeart	peart
britannia	romanbritain
allmanbrothers	theallmanbrothersband
they	ymca
olfaction	smell
bouncer	doorman
cms	contentmanagementsystem
rash	skinrash
pmdd	premenstrualdysphoricdisorder
bigisland	hawaii
amilcareponchielli	ponchielli
christopherwren	sirchristopherwren
oxfordshire	oxon
cardassianunion	cardassian
johnpaulii	popejohnpaulii
idm	intelligentdancemusic
swansongrecords	swansong
inches	inch
afroasiatic	afroasiaticlanguages
gregoryv	popegregoryv
bigpinekey	bigpine
lion	pantheraleo
specials	thespecials
brahms	johannesbrahms
vertebrata	vertebrate
ficus	fig
carlgustavjung	carljung
covertaction	covertoperation
miyagiprefecture	miyagi
chrysalisrecords	chrysalis
betrothal	engagement
majorca	mallorca
yeniseiriver	yenisey
stationagent	stationmaster
generalaccountingoffice	governmentaccountabilityoffice
sansinstitute	sans
kimkardashian	kim
abruzzi	abruzzo
abolitionism	abolitionist
naras	therecordingacademy
kylieminogue	kylie
bbc2	bbctwo
canadianfootballleague	cfl
taste	thetaste
siouxsiesioux	siouxsie
plans	plan
citycentre	manchestercitycentre
unitarianuniversalism	unitarianuniversalist
musclepain	myalgia
charleswheatstone	sircharleswheatstone
opensourceinitiative	osi
octa	orangecountytransportationauthority
bostonpopsorchestra	bostonpops
carbondioxide	co2
awol	desertion
ketubah	marriagecontract
bonhamcarter	helenabonhamcarter
primeministertonyblair	tonyblair
itunesmusicstore	itunesstore
secondvaticancouncil	vaticanii
tanjore	thanjavur
marsh	morass
mentalfunction	mentalprocess
bakingsoda	sodiumbicarbonate
chams	cham
gudrun	kriemhild
hpylori	helicobacterpylori
platformgame	platformer
mentalbreakdown	nervousbreakdown
chicomarx	chico
bantupeoples	bantu
arizona	az
igorstravinsky	stravinsky
chineseconstellations	chineseconstellation
hampdenpark	hampden
israelites	israelite
grouchomarx	groucho
teiresias	tiresias
mentha	mint
poles	polishpeople
johncoltrane	trane
generalpractitioner	gp
littleegypt	southernillinois
sabbaticalyear	sabbatical
moorish	moors
advertisingagencies	advertisingagency
sovietunion	ussr
thread	yarn
sichuanprovince	sichuan
tigrisriver	tigris
kilometres	kilometre
marquisdesade	sade
northindia	northernindia
chomsky	noamchomsky
drivingmissdaisy	missdaisy
humanskeleton	skeletalsystem
foxmulder	mulder
caravanpark	rvpark
bigredmachine	thebigredmachine
borinquen	puertorico
emiliaromagna	emilia
floorcovering	flooring
electromagneticpulse	emp
olympicgames	olympics
normanarchitecture	norman
gilbertislands	kiribati
female	girl
congas	conga
changingroom	lockerroom
ilocano	ilokano
hydrologiccycle	watercycle
shanstate	shan
buenosairesprovince	buenosaires
kwazulunatal	natal
simonrattle	sirsimonrattle
orchidaceae	orchid
wcw	worldchampionshipwrestling
hebe	juventas
laurenceolivier	sirlaurenceolivier
bbcradio1	bbcradioone
rnainterference	rnai
daeva	div
hollywoodsquares	thehollywoodsquares
eastindies	indies
expressionism	expressionist
scallions	scallion
crawfish	crayfish
newhampshire	nh
turbocharger	turbo
icu	intensivecareunit
infectiousmononucleosis	mononucleosis
jacobiterebellion	jacobiterisings
kamehamehai	kamehameha
huanghe	yellowriver
greenlantern	haljordan
westtexasintermediate	wti
fungicides	fungicide
dns	domainnamesystem
wiredmagazine	wired
loyaltycard	loyaltyprogram
robertwalpole	sirrobertwalpole
impulsiveness	impulsivity
valentines	valentine
euro	eur
rheinlandpfalz	rhinelandpalatinate
katagalugan	tagalogrepublic
nematode	roundworms
broiling	grilling
arts	thearts
hebrewcalendar	jewishcalendar
blackbeard	edwardteach
crataegus	hawthorn
sharpcorporation	sharp
centralnervoussystem	cns
pants	trousers
costello	loucostello
palaeozoic	paleozoic
bennyandersson	benny
flaminglips	theflaminglips
midwaygames	midway
radiofrequencyidentification	rfid
infrared	ir
lochnessmonster	nessie
wisconsin	wi
nclb	nochildleftbehindact
diodorussiculus	diodorus
chicagosymphonyorchestra	cso
misterfantastic	reedrichards
doublebill	doublefeature
easternseaboard	useastcoast
metropolitantransportationauthority	mta
bassocontinuo	figuredbass
atlantabraves	bostonbraves
fmbroadcasting	fmradio
inclination	orbitalinclination
decompressionsickness	thebends
ostrogoths	ostrogoth
guardian	theguardian
friedrichnietzsche	nietzsche
fashionindustry	fashion
sandman	thesandman
littoralzone	littoral
frankzappa	zappa
jeanracine	racine
klingklangstudio	klingklang
eiffeltower	latoureiffel
vandenbergafb	vandenbergairforcebase
arthropoda	arthropod
isaacnewton	sirisaacnewton
averroes	ibnrushd
bestmotionpicture	outstandingproduction
affleck	benaffleck
punchcard	punchedcard
maximization	profitmotive
la	losangeles
indochina	mainlandsoutheastasia
rosettatharpe	sisterrosettatharpe
berlinairlift	berlinblockade
specialforces	specialoperationsforces
corn	maize
northamptonshire	northants
adarii	adar
mukden	shenyang
washingtonstateuniversity	wsu
footballleaguechampionship	thechampionship
artgallery	artmuseum
saudiarabianairlines	saudia
flushing	vlissingen
romulusaugustulus	romulusaugustus
almshouses	almshouse
1stavenue	firstavenue
hst	hubblespacetelescope
crystalpalacefc	crystalpalace
vanswarpedtour	warpedtour
claraschumann	clarawieck
typhoeus	typhon
partridgefamily	thepartridgefamily
amudarya	oxusriver
ntl	virginmedia
arnoldschoenberg	schoenberg
medina	yathrib
forest	nottinghamforest
turnips	turnip
odor	odour
haymarkettheatre	theatreroyalhaymarket
supernovae	supernova
wirelesscommunication	wireless
cockneyrhymingslang	rhymingslang
ashoka	asoka
tyndallafb	tyndallairforcebase
chaucer	geoffreychaucer
clare	countyclare
bonnieprincecharlie	charlesedwardstuart
x11	xwindowsystem
exercise	physicalexercise
z80	zilogz80
charlesdickens	dickens
rutgersuniversity	rutgers
robertschumann	schumann
bharatiyajanataparty	bjp
grandprixmotorcycleracing	motogp
davidletterman	letterman
iannisxenakis	xenakis
cfo	chieffinancialofficer
torpedobomber	torpedo
pstn	publicswitchedtelephonenetwork
chrome	googlechrome
valar	vala
burns	burn
parlophonerecords	parlophone
athleticbilbao	athleticclub
formula2	formulatwo
westerncivilization	westernculture
newyorkuniversity	nyu
englishamericans	englishamerican
agerelatedmaculardegeneration	maculardegeneration
husaynibnali	husseinibnali
allergies	allergy
dayakpeople	dayak
reval	tallinn
tartaricacid	tartrate
myopathies	myopathy
flaviusjosephus	josephus
defjamrecordings	defjam
jamesbowie	jimbowie
friso	princefriso
sco	shanghaicooperationorganisation
stringinstruments	stringinstrument
lives	parallellives
bridegroom	groom
mainlineprotestant	mainline
orrinhatch	senatorhatch
headaches	headache
monkees	themonkees
popmusic	pop
caucasian	white
bluesmusic	blues
easternorthodoxchurch	easternorthodoxy
endemic	endemism
nato	northatlantictreatyorganization
strangling	strangulation
solubility	soluble
insights	insight
onlineauctions	onlineauction
islamicworld	muslimworld
animals	theanimals
harpomarx	harpo
indianajones	indy
hollomanafb	hollomanairforcebase
welshlanguage	welsh
nortelnetworks	nortel
nellisafb	nellisairforcebase
moogsynthesizer	moog
povertyalleviation	povertyreduction
captainjohnsmith	johnsmith
televisionnewzealand	tvnz
hermitagemuseum	statehermitagemuseum
jove	jupiter
antonrubinstein	rubinstein
cork	countycork
socialistleftparty	sv
environmentalremediation	remediation
semiology	semiotics
painmanagement	painmedicine
rangefindercamera	rangefinder
sketchcomedy	sketch
advancedmicrodevices	amd
radhakrishnan	sarvepalliradhakrishnan
lebronjames	lebron
ginrummy	gin
mcg	melbournecricketground
hellenisticcivilization	hellenisticperiod
solarmasses	solarmass
noblemetals	noblemetal
countymayo	mayo
clujnapoca	cluj
cab	taxicab
shaolinmonastery	shaolintemple
blackeyedpeas	theblackeyedpeas
rapture	therapture
generalanaesthesia	generalanesthesia
takeshikitano	takeshi
color	colour
handheld	mobiledevice
gustavholst	holst
humber	riverhumber
cubits	cubit
forestlawncemetery	forestlawnmemorialpark
midwesternunitedstates	midwest
woodywoodpecker	woody
antonvanleeuwenhoek	antonievanleeuwenhoek
henrymancini	mancini
abominablesnowman	yeti
hondacenter	thepond
institutions	institution
v2rocket	v2
hina	ina
catherinezetajones	zetajones
mexicans	mexican
fortcarillon	fortticonderoga
pyruvate	pyruvicacid
aud	australiandollar
westernmovie	western
sirthomasbeecham	thomasbeecham
fortunes	thefortunes
presidentrichardnixon	richardnixon
etruscanlanguage	etruscan
marquess	marquis
musicnotation	musicalnotation
bbb	betterbusinessbureau
kings	sacramentokings
regulatoryagency	regulatoryauthority
marinescience	oceanography
yongleemperor	zhudi
santacruzdelasierra	santacruz
lockerbiebombing	panamflight103
esfahan	isfahan
princessleiaorgana	princessleia
terminator	theterminator
pet	positronemissiontomography
september	sep
heilongjiangprovince	heilongjiang
fatigue	metalfatigue
loch	lough
augustinians	augustinian
selfconfidence	selfconfident
heinrichhimmler	himmler
associates	theassociates
urdulanguage	urdu
ditko	steveditko
gogol	nikolaigogol
geneticmutation	mutation
northernpacificrailroad	northernpacificrailway
grimm	jacobgrimm
qld	queensland
friedrichbessel	friedrichwilhelmbessel
drowsiness	somnolence
batman	brucewayne
georgphilipptelemann	telemann
beetroot	beet
cylinder	cylindrical
drugaddiction	drugdependence
sirwalterraleigh	walterraleigh
jewishdenominations	jewishreligiousmovements
silverstonecircuit	silverstone
floydmayweatherjr	floydmayweather
brassknuckles	knuckles
joseph	yosef
coblenz	koblenz
trafficlight	trafficsignal
atlanticintracoastalwaterway	intracoastalwaterway
afghanwhigs	theafghanwhigs
hammerfilmproductions	hammerhorror
fenderrhodes	rhodespiano
graphicaluserinterface	gui
papalcourt	papalhousehold
uniformresourceidentifier	uri
ecoli	escherichiacoli
unitedserviceorganizations	uso
requiemmass	requiem
anatomicallymodernhumans	homosapienssapiens
nationalism	nationalist
mailcarrier	postman
schroonlake	schroon
adultfilm	pornographicfilm
astronaut	cosmonaut
bakhtin	mikhailbakhtin
pensionfunds	pensionfund
violadagamba	viol
wembleystadium	wembley
platters	theplatters
porphyrias	porphyria
oldvictheatre	theoldvic
consumerpriceindex	cpi
cajuncuisine	cajun
westwoodstudios	westwood
lordshiva	shiva
tajmahal	taj
ronettes	theronettes
bigshow	thegiant
halfmast	halfstaff
phibetakappasociety	phibetakappa
adolphzukor	zukor
labradorretriever	labrador
nicholasii	tsarnicholasii
masovia	mazovia
gretzky	waynegretzky
liamgallagher	liam
internet	theinternet
jpeg	jpg
gerihalliwell	geri
senecapeople	senecatribe
iucn	worldconservationunion
ascalon	ashkelon
boss	finalboss
caribbeancuisine	caribbean
tube	tubing
somalilanguage	somali
propertydeveloper	realestatedevelopment
stenosis	stricture
formula3	formulathree
dracomalfoy	draco
brooklyn	kingscounty
harrypotter	harry
brakepads	brakepad
passeriformes	passerine
southasia	southernasia
russianfederation	russia
globuspallidus	pallidum
charpentier	marcantoinecharpentier
playstation2	ps2
flagellation	flogging
plc	publiclimitedcompany
estatetax	inheritancetax
countysligo	sligo
dischordrecords	dischord
righteousbrothers	therighteousbrothers
peachtree	peach
baritonesaxophone	baritonesax
lessersundaislands	nusatenggara
greenhornet	thegreenhornet
aclu	americancivillibertiesunion
endtimes	lastdays
bugsbunny	bugs
volkswagen	vw
holidays	holiday
psveindhoven	psv
faa	federalaviationadministration
traineraircraft	trainer
grammyawards	grammys
bassrivertownship	bassriver
coroners	coroner
americanpsychologicalassociation	apa
mems	microelectromechanicalsystems
miscarriage	spontaneousabortion
carmelites	carmelite
nursery	plantnursery
adobeillustrator	illustrator
creationrecords	creation
mtvunplugged	unplugged
blog	weblog
agt	telus
nonesuchrecords	nonesuch
oldeastslavic	oldrussian
dha	docosahexaenoicacid
tianjin	tientsin
calcutta	kolkata
13colonies	thirteencolonies
annuities	annuity
nbaslamdunkcontest	slamdunkcontest
northwestterritories	nwt
allamerican	allamerica
fairchildafb	fairchildairforcebase
mercuryprogram	projectmercury
parsecs	parsec
holytrinity	trinity
playoffs	playoff
heavymetalmusic	heavymetal
fatty	roscoearbuckle
nationalfilmboard	nfb
drcongo	rdc
groundzero	worldtradecentersite
pop3	postofficeprotocol
religiousmusic	sacredmusic
smiths	thesmiths
clayanimation	claymation
sverigestelevision	svt
cavan	countycavan
animatedgif	gif
moonglows	themoonglows
squaresoft	square
calvinism	calvinist
palaeontology	paleontology
norwegianlanguage	norwegian
malcolmsargent	sirmalcolmsargent
freud	sigmundfreud
legislativepower	legislature
cataracts	cataract
anjouan	nzwani
mexico	unitedmexicanstates
hakkachinese	hakka
organtransplantation	organtransplant
playingcards	playingcard
antoniafraser	ladyantoniafraser
balkanpeninsula	balkans
everglades	floridaeverglades
sportingnews	thesportingnews
squaremetres	squaremetre
oklahomacitythunder	thunder
filmdirector	filmmaker
lombardia	lombardy
logarithms	logarithm
peakdistrictnationalpark	peakdistrict
charlesgounod	gounod
boac	britishoverseasairwayscorporation
pepsicola	pepsi
organdonation	organdonor
francozeffirelli	zeffirelli
newyorkphilharmonicorchestra	newyorkphilharmonic
saracens	saracen
thetriffids	triffids
malignantmelanoma	melanoma
diptera	fly
layman	layperson
computersecurity	cybersecurity
davemustaine	mustaine
torispelling	tori
musicgenre	musicalgenre
johore	johor
theravadabuddhism	theravada
catfish	siluriformes
foodindustry	food
newyorktimesbestsellerlist	thenewyorktimesbestsellerlist
bloodserum	serum
qb	quarterback
stagedirector	theaterdirector
fukushimaprefecture	fukushima
sriinternational	stanfordresearchinstitute
achristmascarol	christmascarol
broadcastjournalism	journalism
akitaprefecture	akita
nasiraldinaltusi	tusi
iran	persia
location	place
germanshepherddog	germanshepherd
australianbroadcastingcommission	australianbroadcastingcorporation
residents	theresidents
mann	thomasmann
algol60	algol
amnesia	memoryloss
methionine	met
altair8800	mitsaltair8800
inorganicchemicals	inorganiccompound
accountancy	accounting
abingtontownship	abington
ketchup	tomatoketchup
fourtops	thefourtops
april	apr
hessen	hesse
romancatholicchurch	thecatholicchurch
erythrocytesedimentationrate	esr
computernetworks	computernetwork
temptations	thetemptations
blackburnrovers	rovers
internationaltaekwondofederation	itf
countrymusic	country
dariusmilhaud	milhaud
golf	volkswagengolf
chemicalnomenclature	iupacnomenclature
ells	ell
francispoulenc	poulenc
polynomialtime	timecomplexity
rnli	royalnationallifeboatinstitution
kingwillemalexander	willemalexander
tamerlane	timur
midnightspecial	themidnightspecial
gaviiformes	loon
dido	elissa
hejaz	hijaz
herbertvonkarajan	karajan
stoicism	stoic
electronicnoise	noise
byrd	williambyrd
kharkiv	kharkov
dystheism	misotheism
tabletcomputer	tablet
chineselanguage	chinese
mantaray	manta
phantomblot	thephantomblot
polynesian	polynesia
dieselfuel	diesel
pittsburghsteelers	steelers
shields	shield
localfood	local
bacteria	bacterium
newscotlandyard	scotlandyard
milano	milan
naturalsciences	naturalscience
genitivecase	genitive
alexanderscriabin	scriabin
canton	guangzhou
threonine	thr
bretagne	brittany
ent	otolaryngology
channelnine	ninenetwork
peregrinefalcon	peregrine
complementarycolors	complementarycolor
fabulousthunderbirds	thefabulousthunderbirds
musictheatre	musicaltheatre
glider	sailplane
chennai	madras
climatechange	globalwarming
cold	commoncold
johnmerrick	josephmerrick
bp	britishpetroleum
computersoftware	software
bobsled	bobsleigh
coding	computerprogramming
liaoningprovince	liaoning
johannschmidt	redskull
oak	quercus
adelphitheatre	adelphi
nurseryrhymes	nurseryrhyme
countyleitrim	leitrim
arminius	hermann
archaeology	archeology
excel	microsoftexcel
iec	internationalelectrotechnicalcommission
openuniversity	theopenuniversity
armenianlanguage	armenian
birminghamsymphonyorchestra	cbso
chloride	chlorine
flaubert	gustaveflaubert
chinesemartialarts	kungfu
rembrandtvanrijn	rembrandt
gospelmusic	gospel
claudiomonteverdi	monteverdi
graphicartist	graphicdesigner
genderidentitydisorder	gid
hydra	lernaeanhydra
christiandior	dior
charlesxavier	professorx
benjaminbritten	britten
sinhala	sinhalese
oiltanker	petroleumtanker
coranglais	englishhorn
atari8bitfamily	atari800
portland	rosecity
michaelnesmith	mikenesmith
stevewozniak	woz
motorsports	motorsport
chibaprefecture	chiba
belllaboratories	belllabs
norrbottencounty	norrbotten
frusciante	johnfrusciante
countydurham	durham
floatingbridge	pontoonbridge
anxietydisorders	anxietydisorder
columba	saintcolumba
molotov	vyacheslavmolotov
html	hypertextmarkuplanguage
ds1	t1
alquds	jerusalem
faces	thefaces
siam	thailand
doors	thedoors
saroscycle	saros
octoberwar	yomkippurwar
bk	burgerking
edwardhopper	hopper
constantinople	istanbul
fractalgeometry	fractal
globalisation	globalization
cityplanning	urbandevelopment
holymountain	mountathos
aomoriprefecture	aomori
sirthomasmalory	thomasmalory
seeds	seed
unep	unitednationsenvironmentprogramme
enduserlicenseagreement	eula
eib	europeaninvestmentbank
felixmendelssohn	mendelssohn
unitedstatescoastguard	uscg
dianaprince	wonderwoman
dniesterriver	dniester
bukovina	northernbukovina
valueaddedtax	vat
gustavmahler	mahler
torontotransitcommission	ttc
capabilitymaturitymodel	cmm
ribonucleicacid	rna
aurobindo	sriaurobindo
easternhandynasty	handynasty
chan	jackiechan
akhenaten	amenhotepiv
nationalfootballconference	nfc
georgevi	kinggeorgevi
monuc	monusco
firenze	florence
epiphany	twelfthday
ldopa	levodopa
grandecomore	ngazidja
brownuniversity	brown
magnetoencephalography	meg
congee	riceporridge
nadph	nadp
churchbody	localchurch
flyingburritobrothers	theflyingburritobrothers
twelvers	twelver
astrodynamics	orbitalmechanics
smallfaces	thesmallfaces
sonymusicentertainment	sonymusic
kentuckyfriedchicken	kfc
germanarmy	heer
militaryjustice	militarylaw
sodiumdodecylsulfate	sodiumlaurylsulfate
macross	thesuperdimensionfortressmacross
anakinskywalker	darthvader
chicagotransitauthority	cta
antisocialpersonalitydisorder	antisocial
michael	saintmichael
britishtelecom	btgroup
volts	volt
rabindranathtagore	tagore
boulderdam	hooverdam
automaker	automotiveindustry
4wd	fourwheeldrive
peterscott	sirpeterscott
localgovernment	municipalgovernment
modernism	modernist
cloves	clove
middlepersian	pahlavi
moodyblues	themoodyblues
amazonkindle	kindle
kiteboarding	kitesurfing
miles	mile
kfor	kosovoforce
estonianlanguage	estonian
financialtimes	thefinancialtimes
texas	tx
countyroad	countyroute
heresies	heresy
saharadesert	sahara
postgresql	postgres
abdulkalam	kalam
francisbacon	sirfrancisbacon
evertonfc	everton
extensiblemarkuplanguage	xml
localsupercluster	virgosupercluster
playstationportable	psp
walmartstores	walmart
soekarno	sukarno
pollingplace	pollingstation
safaviddynasty	safavidempire
rhineriver	rhine
barbiedoll	barbie
game	thegame
engine	motor
cherokeenation	cherokee
unitedartistsrecords	unitedartists
cockfighting	cockfight
scanningelectronmicroscope	sem
documentobjectmodel	dom
mountlaureltownship	mountlaurel
cathoderaytube	crt
alcatrazisland	alcatraz
tiberriver	tiber
telegraphy	telegraph
argument	arg
busan	pusan
filetransferprotocol	ftp
robertpeel	sirrobertpeel
jam	thejam
disabilities	disability
frankenstein	themonster
oilsands	tarsands
americanpublicmedia	apm
babylonian	babylonia
opticalfiber	opticalfibre
hammer	mchammer
steaks	steak
standard	technicalstandard
barbarianinvasions	migrationperiod
mikvah	mikveh
amoy	xiamen
sedatives	sedative
points	point
chernobylaccident	chernobyldisaster
citycenter	newyorkcitycenter
viipuri	vyborg
seagatetechnology	seagate
sportscommentator	sportscaster
projects	project
phonogramrecords	phonogram
cfd	computationalfluiddynamics
sondheim	stephensondheim
boisecity	boise
bede	venerablebede
alternation	snub
priestess	priest
impressions	theimpressions
november	nov
harddiskdrive	hdd
penguins	penguin
learningdisabilities	learningdisability
yellowmagicorchestra	ymo
uml	unifiedmodelinglanguage
rs	runescape
2012summerparalympics	paralympics
personaldevelopment	personalgrowth
telugulanguage	telugu
multiplemyeloma	myeloma
homearmy	polishhomearmy
nearearthobject	neos
goiter	goitre
ariaawards	ariamusicawards
ammo	ammunition
wiltshire	wilts
jal	japanairlines
jhu	johnshopkinsuniversity
gamedevelopersconference	gdc
ascensionday	ascension
sulfurdioxide	sulphurdioxide
hypovolemia	hypovolemicshock
opengroup	theopengroup
calicut	kozhikode
moralism	morality
loganairport	loganinternationalairport
parody	spoof
folate	folicacid
queenwilhelmina	wilhelmina
imperialcouncil	reichsrat
drowned	drowning
cure	thecure
babyloniantalmud	talmud
geminiprogram	projectgemini
highcommissioner	highcommission
helsingfors	helsinki
radians	radian
recreationalvehicle	rv
tanach	tanakh
haroldgodwinson	haroldii
lysine	lys
icbm	intercontinentalballisticmissile
ronwood	ronniewood
brownrat	rattusnorvegicus
dohc	sohc
win32	windowsapi
microsoftoffice	office
modelunitednations	modelun
agnosticism	agnostic
minnesotatimberwolves	timberwolves
emesis	vomiting
malteselanguage	maltese
playstationnetwork	psn
aramaeans	arameans
ftse100index	ftse100
fragilexsyndrome	fxs
donizetti	gaetanodonizetti
papsmear	paptest
latinlanguage	latin
britishsignlanguage	bsl
easternbloc	sovietbloc
alcoholintoxication	inebriated
lan	localareanetwork
complex	coordinationcomplex
nationallaborrelationsboard	nlrb
aluminium	aluminum
bark	barque
portwine	port
animalfeed	fodder
nazigermany	thirdreich
dixiechicks	thedixiechicks
baseten	decimal
creditcards	creditcard
kingsolomon	solomon
borussiadortmund	dortmund
niacin	nicotinicacid
breathlessness	dyspnea
check	cheque
discgolf	frisbeegolf
mauryaempire	mauryanempire
comptroller	controller
philipsidney	sirphilipsidney
riodejaneiro	rio
desmoines	fortdesmoines
digitalsubscriberline	dsl
protista	protist
vfx	visualeffects
britishoverseasterritories	britishoverseasterritory
jewish	judaism
rebecca	rebekah
rccola	royalcrown
countymonaghan	monaghan
lpgatour	lpga
filmmusic	filmscore
dadaism	dada
package	softwarepackage
northvietnamesearmy	vpa
camaro	chevroletcamaro
panzer	tank
lastsupper	thelastsupper
traincrash	trainwreck
greatertorontoarea	gta
boniface	saintboniface
dailyvariety	variety
sirwilliamherschel	williamherschel
countywicklow	wicklow
southwestconference	swc
seminoleindians	seminole
chuangtzu	zhuangzi
philipmelanchthon	philippmelanchthon
alternatehistory	alternativehistory
ide	integrateddevelopmentenvironment
kelvins	kelvin
rb	rubidium
shamanism	shaman
esa	europeanspaceagency
footballassociation	thefootballassociation
unitarianism	unitarian
taitocorporation	taito
baruchspinoza	spinoza
anura	frog
humanleague	thehumanleague
countykildare	kildare
londonblitz	theblitz
puranas	puranic
suebi	suevi
franzkafka	kafka
popculture	popularculture
antitrust	competitionlaw
kailuakona	kailua
marathilanguage	marathi
mostvaluableplayer	mvp
portsmouthnavalshipyard	portsmouthnavyyard
ngo	nongovernmentalorganization
colindavis	sircolindavis
annamarie	rogue
ramdass	richardalpert
leicacamera	leitz
krakatau	krakatoa
thewiggles	wiggles
stones	stone
romberg	sigmundromberg
firewire	ieee1394
internationalriceresearchinstitute	irri
falcon	thefalcon
radiationtherapy	radiotherapy
allandwan	dwan
stanforduniversity	stanford
avemaria	hailmary
picardie	picardy
bryozoa	ectoprocta
pierreelliotttrudeau	pierretrudeau
mercedesbenz	mercedes
eds	electronicdatasystems
presocraticphilosophy	presocratic
mongolianlanguage	mongolian
cortisol	hydrocortisone
offspring	theoffspring
collingwoodfootballclub	magpies
verandah	veranda
bullying	bully
sheltie	shetlandsheepdog
feynman	richardfeynman
dsmivtr	dsm
johnbetjeman	sirjohnbetjeman
shadows	theshadows
championsleague	europeancup
fmd	footandmouthdisease
mtvvideomusicaward	vma
jiddukrishnamurti	krishnamurti
movementdisorders	movementdisorder
studentcouncil	studentgovernmentassociation
aragon	louisaragon
palaeolithic	paleolithic
v8supercars	v8supercar
communism	communist
northumbriandialect	northumbrian
arthursullivan	sirarthursullivan
spc	statisticalprocesscontrol
parsippanytroyhills	parsippany
stories	thestories
fertilisation	fertilization
nucleartransmutation	transmutation
illyrian	illyria
pertussis	whoopingcough
biomedicalsciences	healthsciences
cosanostra	sicilianmafia
naraprefecture	nara
littlebear	ursaminor
pontiacsilverdome	silverdome
marshalltucker	themarshalltuckerband
juventus	juve
xmansion	xavierinstitute
skateboardpark	skatepark
washer	washingmachine
azimuthal	azimuth
airbase	militaryairbase
pryorcreek	pryor
volkswagenbeetle	vwbeetle
haku	meng
iontelevision	paxtv
conifers	pinophyta
performancearts	performanceart
sandbar	shoal
gasbladder	swimbladder
atomicforcemicroscope	atomicforcemicroscopy
francia	frankishkingdom
intellectualproperty	ip
edinburghfestivalfringe	edinburghfringefestival
nafta	northamericanfreetradeagreement
antonbruckner	bruckner
cmaawards	countrymusicassociationawards
afdb	africandevelopmentbank
japanselfdefenseforces	jsdf
lifetimetelevision	lifetime
geezerbutler	geezer
musicdirector	musicaldirector
captain	navalcaptain
racingclub	racing
anthologyfilm	anthology
bluegrassmusic	bluegrass
chronicmyelogenousleukemia	cml
chamorropeople	chamorros
electromotivediesel	emd
classicalarchitecture	classical
blonde	blond
barns	barn
annapurnai	annapurna
languagerevitalization	languagerevival
billboardmagazine	billboard
valenciacf	valencia
neighborhoods	neighbourhood
socialanxietydisorder	socialphobia
jennifersaunders	saunders
tnt	trinitrotoluene
deweydecimalclassification	deweydecimalsystem
tribunecompany	tribunemedia
agglomeration	urbanagglomeration
souk	souq
dokdo	liancourtrocks
cyanides	cyanide
basso	bass
altria	philipmorris
boardgames	boardgame
charites	graces
borealforest	taiga
racecourse	racetrack
noodles	noodle
godfather	thegodfather
unitedstatescensusbureau	uscensusbureau
harare	salisbury
howardzinn	zinn
creek	mvskoke
jaffa	joppa
fdi	foreigndirectinvestment
corozaldistrict	corozal
julesmassenet	massenet
beading	beadwork
wimbledonchampionships	wimbledon
obe	outofbodyexperience
leukaemia	leukemia
hanswernerhenze	henze
eidosinteractive	eidos
solaryear	tropicalyear
months	month
rangoon	yangon
detroitnews	thedetroitnews
atlanticrecords	atlantic
carpet	rug
anilingus	rimming
ganesha	ganesh
nc	northcarolina
studentmagazine	studentnewspaper
mediterraneansea	mediterranean
amoraim	amora
wheelerarmyairfield	wheelerfield
tms	transcranialmagneticstimulation
fernandopessoa	pessoa
isaac	yitzchak
kittypryde	shadowcat
londonweekendtelevision	lwt
foodallergies	foodallergy
vjs	vj
shandongprovince	shandong
confederatearmy	confederatestatesarmy
bitola	monastir
typhoidfever	typhoid
cherbourgocteville	cherbourg
countydonegal	donegal
nyssa	tupelo
queenscounty	queens
dci	drumcorpsinternational
leghorn	livorno
sertraline	zoloft
procreation	reproduction
geneticengineering	geneticmodification
sammydavisjr	sammydavis
sadc	southernafricandevelopmentcommunity
beautycontest	beautypageant
copier	photocopier
curtiz	michaelcurtiz
nmu	northernmichiganuniversity
jamesstewart	jimmystewart
knockout	technicalknockout
santiagodechile	santiago
goannas	monitorlizard
joebiden	vicepresidentjoebiden
peterustinov	ustinov
saintmalo	stmalo
georgemasonuniversity	gmu
blackkeys	theblackkeys
maharajah	maharaja
lendleaseact	lendlease
lawenforcementofficer	peaceofficer
farads	farad
douglasmacarthur	generalmacarthur
statefarminsurance	statefarm
worldwildlifefund	wwf
speechdisorders	speechdisorder
moscowoblast	moscowregion
ishikawaprefecture	ishikawa
raptors	torontoraptors
odysseus	ulysses
johnbarbirolli	sirjohnbarbirolli
domenicoscarlatti	scarlatti
antivirussoftware	antivirus
millsbrothers	themillsbrothers
elm	ulmus
nationalgovernment	nationalunitygovernment
orvillewright	wrightbrothers
khyberpakhtunkhwa	nwfp
julesverne	verne
tokyoimperialuniversity	tokyouniversity
finalsmvp	nbafinalsmvp
cc	creativecommons
lymphomas	lymphoma
tagusriver	tagus
motherearth	mothernature
diuretics	diuretic
pac12	pacific12conference
gracekelly	princessgrace
dunkerque	dunkirk
incheon	inchon
jacquesyvescousteau	jacquescousteau
bradycardia	slowheartrate
danishlanguage	danish
hemolyticuremicsyndrome	hus
emmanuel	immanuel
polysaccharides	polysaccharide
liquidoxygen	lox
searchengineoptimization	seo
element114	flerovium
sithlord	sith
gangster	mobster
fathoms	fathom
canadageese	canadagoose
nestorianism	nestorian
alcatellucent	alcatel
enniomorricone	morricone
beatmusic	merseybeat
itaipudam	itaipu
scottishpeople	scottish
genesiskel	siskel
ciaworldfactbook	theworldfactbook
boilingwaterreactor	bwr
charlesmariewidor	widor
alansilvestri	silvestri
acceptancetesting	acceptancetest
executivebranch	executivepower
hebercity	heber
easteregghunt	egghunt
pelvicinflammatorydisease	pid
southeastunitedstates	southeasternunitedstates
pcengine	turbografx16
highland	upland
classicalmusic	westernartmusic
republicannationalcommittee	rnc
commodorevic20	vic20
hotsprings	hotspring
vaishnava	vaishnavism
blockprinting	woodblockprinting
selenium	se
newyorkworld	theworld
powercenter	retailpark
ladymargaretbeaufort	margaretbeaufort
sulfuricacid	sulphuricacid
hollies	thehollies
jamesmadisonuniversity	jmu
djpremier	primo
fruitjuice	juice
holythursday	maundythursday
smithsonianinstitution	smithsonian
iseult	isolde
nisse	tomte
islandrecords	island
jerkyboys	thejerkyboys
bmc	britishmotorcorporation
tyrannosaurusrex	tyrannosaurus
meltdownfestival	meltdown
flagshipstation	flagship
dio	ronniejamesdio
amor	cupid
germanpeople	germans
gibibyte	gib
drymouth	xerostomia
henrys	henry
scepterrecords	scepter
parliamentarydemocracy	parliamentarysystem
bicycle	bike
groundwaterrecharge	recharge
achaea	achaia
brutalistarchitecture	brutalist
chowchow	chow
medicalspecialty	specialty
caruso	enricocaruso
giulianodellarovere	popejuliusii
leonardmccoy	mccoy
henryrollins	rollins
spectre	thespectre
brassinstrument	brass
confederatenavy	confederatestatesnavy
scoutassociation	thescoutassociation
celebes	sulawesi
psychedelicfurs	thepsychedelicfurs
lh2	liquidhydrogen
lyons	lyon
toyotamotorcorporation	toyota
naples	napoli
esc	eurovisionsongcontest
minotafb	minotairforcebase
goryeodynasty	goryeo
okinawaprefecture	okinawa
hess	rudolfhess
earlychristianity	earlychristian
sonnybono	sonny
cubicmetres	cubicmetre
li	ri
revisioncontrol	scm
alternativerock	alternative
parisreview	theparisreview
chinesechess	xiangqi
architecturalmodels	architecturalmodel
deacons	deacon
alfredpennyworth	alfred
krishna	lordkrishna
albusdumbledore	dumbledore
searchers	thesearchers
tlingitlanguage	tlingit
billsikes	sykes
cassiusclay	muhammadali
caving	spelunking
humanvoice	vocal
romanticcomedyfilm	romanticcomedy
fdp	freedemocraticparty
geographicinformationsystem	gis
zamboangacity	zamboanga
jeandelafontaine	lafontaine
celiacdisease	coeliacdisease
halprince	haroldprince
collaborativesoftware	groupware
elementaryschool	primaryschool
drjohnson	samueljohnson
bat	chiroptera
replacements	thereplacements
nfleuropa	nfleurope
highbloodpressure	hypertension
knack	theknack
koran	quran
renaissancearchitecture	renaissance
frenchopen	rolandgarros
southsudan	southernsudan
ccf	combinedcadetforce
elliceislands	tuvalu
days	day
czechlanguage	czech
javascript	js
beverage	drink
patel	vallabhbhaipatel
jamestownsettlement	jamestown
lithuanianlanguage	lithuanian
cardiganshire	ceredigion
cirrhosis	livercirrhosis
clean	theclean
computedtomography	ctscan
everlybrothers	theeverlybrothers
etiquette	manners
dentalcaries	toothdecay
aelian	claudiusaelianus
enlargedlymphnodes	lymphadenopathy
nightmares	nightmare
fct	federalcapitalterritory
icelandiclanguage	icelandic
nationalbasketballassociation	nba
humantorch	johnnystorm
yamunariver	yamuna
zambeziriver	zambezi
samoa	westernsamoa
edomites	edom
beegees	thebeegees
sikhgurus	sikhguru
coachellafestival	coachella
kiev	kyiv
biopolymers	biopolymer
bulwerlytton	edwardbulwerlytton
othello	reversi
comatose	coma
613commandments	613mitzvot
vilna	vilnius
onlineshopping	onlinestore
au	gold
charitableorganization	charity
cardiacmuscle	myocardium
hotlatinsongs	hotlatintracks
jordanriver	riverjordan
logan	wolverine
orientalism	orientalist
blekingecounty	blekinge
britishempiregames	commonwealthgames
sacd	superaudiocd
captainkirk	kirk
ironman	tonystark
marxism	marxist
misspiggy	piggy
musicvideos	musicvideo
prokofiev	sergeiprokofiev
quotations	quotation
bigfoot	sasquatch
whitearmy	whitemovement
syriaclanguage	syriac
dorsetshire	dorset
bnp	britishnationalparty
norad	northamericanaerospacedefensecommand
mickeymouseclub	themickeymouseclub
jarre	mauricejarre
arthur	kingarthur
missyelliott	missy
mediterraneanbasin	mediterraneanregion
finch	fringillidae
carnivores	carnivore
ewingtownship	ewing
israel	jacob
p53	tp53
romulanstarempire	romulan
abelincoln	abrahamlincoln
alco	americanlocomotivecompany
earlycretaceous	lowercretaceous
guesswho	theguesswho
countylouth	louth
scotty	scott
gaiusjuliuscaesar	juliuscaesar
inflammation	inflammatoryreaction
kachinas	kachina
maceoparker	maceo
theventures	ventures
gaa	gaelicathleticassociation
greatbear	ursamajor
firstpastthepostvoting	firstpastthepost
orkneyislands	orkney
bloodgroup	bloodtype
zakynthos	zante
babymario	mario
fruits	fruit
johngielgud	sirjohngielgud
hindemith	paulhindemith
bulldogs	bulldog
registerednurse	rn
footbridge	pedestrianbridge
ninja	shinobi
spaniards	spanishpeople
arcangelocorelli	corelli
relationaldatabasemanagementsystem	relationaldatabase
anabaptists	anabaptist
saloon	sedan
charismarecords	charisma
yards	yard
comte	count
hanyupinyin	pinyin
kikongo	kongo
georgecostanza	george
frobisherbay	iqaluit
3ds	nintendo3ds
marcoisland	marco
europeancommunity	europeaneconomiccommunity
giorgiomoroder	moroder
bellini	vincenzobellini
paulverlaine	verlaine
antipsychotics	antipsychotic
hives	urticaria
kinshasa	leopoldville
ainulanguage	ainu
dissociativeidentitydisorder	multiplepersonalitydisorder
chapter7bankruptcy	chapter7
algebraicchessnotation	algebraicnotation
fonzie	thefonz
medicalcannabis	medicalmarijuana
philadelphiaphillies	phillies
damejudidench	judidench
sampler	samples
cgi	computergeneratedimagery
passover	pesach
battleshippotemkin	thebattleshippotemkin
windowsmediaaudio	wma
nancyreagan	nancy
bulls	chicagobulls
carbolicacid	phenol
britishtouringcarchampionship	btcc
archangelgabriel	gabriel
finearts	fineart
mountain	peak
oprahwinfrey	oprah
annacomnena	annakomnene
sarasvati	saraswati
biographicalfilm	biopic
newzealand	nz
westernmichiganuniversity	wmu
menstruation	periods
osakaprefecture	osaka
confusion	mentalconfusion
contiguousunitedstates	lower48
doncarlos	doncarlo
malaylanguage	malay
hartfordwhalers	newenglandwhalers
worldchesschampionship	worldchesschampion
mercurymusicprize	mercuryprize
religioustext	scripture
guydemaupassant	maupassant
easternmichiganuniversity	emu
siriusb	sirius
b12	vitaminb12
coenzymeq10	coenzymeq
bae	britishaerospace
claudemonet	monet
echocardiogram	echocardiography
marcelproust	proust
slotmachine	slots
sirwilfridlaurier	wilfridlaurier
powcamp	prisonerofwarcamp
psychiatricmedications	psychiatricmedication
mediaplayer	windowsmediaplayer
midfielder	midfield
extratime	overtime
newmexicostateuniversity	nmsu
cheguevara	che
airship	dirigible
saintpaul	saul
royaldutchshell	shell
disneylandrecords	waltdisneyrecords
maasaipeople	masai
heitorvillalobos	villalobos
princerainieriii	rainieriii
brasil	brazil
baptism	christening
fricka	frigg
ietf	internetengineeringtaskforce
pyotrilyichtchaikovsky	tchaikovsky
blackfrancis	frankblack
2014fifaworldcup	2014worldcup
whitemarshtownship	whitemarsh
intelcorporation	intel
disneychannel	thedisneychannel
brighamyounguniversity	byu
comedydrama	dramedy
bulgarianlanguage	bulgarian
maoism	maoist
hindenburg	paulvonhindenburg
soulmusic	soul
geographical	geography
cephalonia	kefalonia
kawasakiheavyindustries	kawasaki
roanokecounty	roanoke
mahathirbinmohamad	mahathirmohamad
berkeleysoftwaredistribution	bsd
fabaceae	leguminosae
menorca	minorca
endorheicbasin	endorheic
blowfish	pufferfish
countdracula	dracula
imperialcollegelondon	imperialcollege
divinecomedy	thedivinecomedy
kandaharprovince	kandahar
livonian	liv
theuniverse	universe
gad	generalizedanxietydisorder
angus	forfarshire
theuncertaintyprinciple	uncertaintyprinciple
parfum	perfume
makkah	mecca
nationalactionparty	pan
headstartprogram	headstart
treves	trier
antarctica	antarctic
pcos	polycysticovarysyndrome
homeopathy	homoeopathy
michelangelobuonarroti	michelangelo
anthocyanins	anthocyanin
ebm	electronicbodymusic
saptarishi	saptarshi
macedonianslavs	macedonians
creactiveprotein	crp
fairytales	fairytale
rosa	rose
dailycomicstrip	dailystrip
acetylsalicylicacid	aspirin
bonaventure	saintbonaventure
hinduism	hindu
iodine131	radioiodine
publisher	publishing
americanstockexchange	amex
blockbusterentertainmentaward	blockbustervideo
santaclaravalleytransportationauthority	vta
charliemccarthy	edgarbergen
ga	georgia
clarabellecow	clarabelle
georgearmstrongcuster	georgecuster
columbiarecords	columbia
boriskarloff	karloff
maas	meuse
emailspam	spam
aclockworkorange	clockworkorange
waylonjennings	waylon
nadershah	nadirshah
compilationalbum	compilation
himyaritekingdom	himyar
kangaroos	northmelbournefootballclub
snoopdogg	snoop
niigataprefecture	niigata
augustine	saintaugustine
generations	generation
condottiere	condottiero
charlesperrault	perrault
detroit	motorcity
sanchopanza	sancho
windinstruments	windinstrument
animated	animation
tumor	tumour
aga	agha
nonsmallcelllungcancer	nsclc
bundesmarine	germannavy
linoleate	linoleicacid
sindh	sind
surrealism	surrealist
bucs	tampabaybuccaneers
yiddishlanguage	yiddish
oakenfold	pauloakenfold
collagens	collagen
leuven	louvain
johnlennon	lennon
eso	europeansouthernobservatory
amir	emir
newyorkyankees	yankees
barneygumble	barney
worksprogressadministration	wpa
gainsbourg	sergegainsbourg
jadis	whitewitch
cerebrospinalfluid	csf
muterecords	mute
partisans	yugoslavpartisans
diana	diane
sunmicrosystems	sun
marchairreservebase	marchfield
rascals	therascals
byzantinegreek	medievalgreek
cah	congenitaladrenalhyperplasia
motherroad	us66
chopper	helicopter
canadaday	dominionday
ciclosporin	cyclosporine
francisdrake	sirfrancisdrake
sodiumthiopental	thiopental
traditionalcatholic	traditionalistcatholic
ismband	ism
consistencyproof	consistency
bowls	lawnbowls
kingcole	natkingcole
nfcchampionshipgame	nfcchampionship
veganism	vegan
highnumbers	thewho
montana	mt
presidentreagan	ronaldreagan
burr	bur
athabascan	athabaskanlanguages
lichtenstein	roylichtenstein
amitabhbachchan	amitabh
alfredhitchcock	hitch
jonforeman	jon
environmentalsciences	environmentalscience
entranceexamination	entranceexam
staplesingers	thestaplesingers
countygalway	galway
tcp	transmissioncontrolprotocol
garage	ukgarage
democraticparty	democrats
babyloniancaptivity	babylonianexile
hummel	johannnepomukhummel
icp	insaneclownposse
sevilla	seville
arthureddington	arthurstanleyeddington
overwintering	overwinter
georgewashingtonuniversity	thegeorgewashingtonuniversity
megabits	megabit
bosnianlanguage	bosnian
methodism	methodistchurch
firstfrenchrepublic	frenchfirstrepublic
physicaltherapy	physiotherapy
africanbuffalo	capebuffalo
greeklanguage	greek
newyorkgiants	sanfranciscogiants
poplar	populus
popstandards	traditionalpopmusic
bull	groupebull
asd	autismspectrum
sce	sonycomputerentertainment
organisedcrime	organizedcrime
metricsystem	si
federicofellini	fellini
lexingtonfayette	lexington
nes	nintendoentertainmentsystem
cistercians	cistercian
crosscountryskiing	crosscountryski
sarah	sarai
dielectrics	dielectric
borders	scottishborders
computerdisplay	computermonitor
londonsymphonyorchestra	lso
highrise	towerblock
deepveinthrombosis	dvt
scotslanguage	scots
karolszymanowski	szymanowski
bealeafb	bealeairforcebase
daodejing	taoteching
mannerism	mannerist
sepsis	septicemia
fascism	fascist
scarabbeetles	scarabs
ufw	unitedfarmworkers
ganondorf	ganon
mobileapps	mobileapp
aaroncopland	copland
retailing	retail
privatecompany	privatelyheldcompany
fdic	federaldepositinsurancecorporation
technology	tech
centralintelligenceagency	cia
leapyears	leapyear
blockisland	newshoreham
venetianlanguage	venetian
jedimaster	jedi
freeman	martinfreeman
electropop	synthpop
buzkashi	kokpar
millajovovich	milla
ralphvaughanwilliams	vaughanwilliams
bomberaircraft	bomber
baudelaire	charlesbaudelaire
nantucketisland	nantucket
pixels	pixel
gustavklimt	klimt
paradigms	paradigm
bvitamins	vitaminb
andromedagalaxy	m31
cinematographer	dp
ethics	moralphilosophy
empresswu	wuzetian
grade12	twelfthgrade
gray	grey
wintergames	winterolympicgames
missionsantabarbara	santabarbaramission
royalballet	theroyalballet
odf	opendocument
frisians	frisian
bastet	bast
giovannipierluigidapalestrina	palestrina
georgefriderichandel	handel
cherylcole	cheryl
ira	irishrepublicanarmy
finnishlanguage	finnish
stalingrad	volgograd
americanculture	americanvalues
sinclairresearch	sinclair
anaesthesia	anesthesia
davidlander	squiggy
nbachampionship	nbafinals
richardwagner	wagner
weatherman	weathermen
kannadalanguage	kannada
gigabytes	gigabyte
hikarusulu	sulu
dravariver	drava
corticosteroids	corticosteroid
sml	standardml
nationalsymbols	nationalsymbol
carrack	nau
provisionalira	provisionalirishrepublicanarmy
equatorialclimate	tropicalrainforestclimate
benfranklin	benjaminfranklin
unitedstatessupremecourt	ussupremecourt
greatfamine	irishpotatofamine
sanfranciscostateuniversity	sfsu
asimov	isaacasimov
cad	computeraideddesign
mi6	secretintelligenceservice
sandinistanationalliberationfront	sandinistas
congobrazzaville	congo
westnilevirus	wnv
houseunamericanactivitiescommittee	huac
diagnosis	medicaldiagnosis
mahayanabuddhism	mahayana
shirelles	theshirelles
gregoriancalendar	westerncalendar
whitedeertownship	whitedeer
tendinitis	tendonitis
herefordshire	hereford
windows	window
dissertation	thesis
hardwicktownship	hardwick
carpaltunnelsyndrome	carpaltunnel
reducedinstructionsetcomputing	risc
bluesbrothers	thebluesbrothers
nebulae	nebula
palestineliberationorganization	plo
languages	linguistics
undp	unitednationsdevelopmentprogramme
cicero	marcustulliuscicero
corporatesocialresponsibility	csr
mohammadrezapahlavi	shahmohammadrezapahlavi
intelligencequotient	iqtest
pinnipedia	pinniped
elopement	elope
lax	losangelesinternationalairport
lowerclass	workingclass
sandiegostateuniversity	sdsu
ccny	citycollege
sonicdrivein	sonic
ianmckellen	sirianmckellen
amoebas	amoeba
basel	basle
fenrir	fenris
bumiputera	bumiputra
davidcrockett	davycrockett
coxcable	coxcommunications
nationalliberationfront	vietcong
helenhayestheatre	littletheatre
hotdogs	hotdog
loge	loki
cartagenadeindias	cartagena
migueldeunamuno	unamuno
laotzu	laozi
fishingboat	fishingvessel
tarotcards	tarot
puertoricans	puertorican
cassel	kassel
microsoftword	word
magazine	periodical
andrewjackson	oldhickory
cablechannel	cablenetwork
sdtv	standarddefinitiontelevision
italianatearchitecture	italianate
airtel	bhartiairtel
appliedarts	appliedart
wutangclan	wutang
upperpalaeolithic	upperpaleolithic
thetimes	times
shemphoward	shemp
malate	malicacid
bostonsymphonyorchestra	bso
sailorvenus	sailorv
nassaucoliseum	nassauveteransmemorialcoliseum
cvspharmacy	cvs
bundesbank	deutschebundesbank
tasmaniantiger	thylacine
congestiveheartfailure	heartfailure
arcadegame	arcade
gentoolinux	gentoo
nativemode	native
stammering	stuttering
saturdaynightlive	snl
shiaislam	shiite
farsightedness	hyperopia
germanicpeoples	germanictribes
currencymarket	foreignexchangemarket
simpsons	thesimpsons
rhodesscholarship	rhodesscholar
fisheries	fishery
perfectaspect	perfect
groundstation	satelliteearthstation
newsconference	pressconference
joejackson	shoelessjoejackson
rotaryclub	rotaryinternational
fantagraphicsbooks	fantagraphics
cherryblossom	sakura
ai	artificialintelligence
sabines	sabine
romanilanguage	romany
ea	electronicarts
eggharbortownship	eggharbor
jeetkunedo	jkd
libertyrecords	liberty
southwestairlines	southwest
continentalag	continental
asiancuisine	asian
waiter	waitress
hollywoodcemetery	hollywoodforevercemetery
metamorphosis	themetamorphosis
thetubes	tubes
chartism	chartist
tcell	tlymphocytes
rnzaf	royalnewzealandairforce
christianmission	mission
b2b	businesstobusiness
complexsystems	complexsystem
hunanprovince	hunan
malacca	melaka
blackjack	twentyone
donatism	donatist
henan	honan
shiraz	syrah
sat	scholasticaptitudetest
lumber	timber
bicarbonate	hydrogencarbonate
christianity	christian
airforceglobalstrikecommand	globalstrikecommand
documentaryfilm	documentary
column	newspapercolumn
hades	pluto
punkrock	punk
neworleans	nola
qpr	queensparkrangers
city	manchestercity
willistowntownship	willistown
brooklynnavyyard	newyorknavyyard
bios	systembios
cmv	cytomegalovirus
ethiopianorthodoxchurch	ethiopianorthodoxtewahedochurch
polpot	salothsar
andesmountains	andes
tradesunioncongress	tuc
marches	march
internationalunits	iu
baronharkonnen	vladimirharkonnen
newworldcommunications	newworldpictures
tau	telavivuniversity
streamlinemoderne	streamline
interstate405	sandiegofreeway
insulae	insula
gravitationalradiation	gravitationalwave
latvianlanguage	latvian
airforceacademy	unitedstatesairforceacademy
ethnicdiversity	multiculturalism
optimization	programoptimization
stardust	timeless
electoralsystem	votingsystem
defenceforces	irishdefenceforces
christophercolumbus	columbus
stonermetal	stonerrock
conocophillips	conoco
xinjianguyghurautonomousregion	xinjiang
playhousetheatre	theplayhouse
mi5	securityservice
diarrhea	diarrhoea
louisianastateuniversity	lsu
frederickwilliam	friedrichwilhelm
fujitelevision	fujitv
borispasternak	pasternak
brianeno	eno
sheriffs	sheriff
banking	bank
tridentmissile	trident
thetroggs	troggs
goldmansachs	goldman
protestantism	protestant
henrikibsen	ibsen
antonchekhov	chekhov
guadianariver	guadiana
gottfriedwilhelmleibniz	leibniz
hawaiianlanguage	hawaiian
kidneyfailure	renalfailure
leoncavallo	ruggeroleoncavallo
feathers	feather
david	kingdavid
dustbrothers	thedustbrothers
arabianpeninsula	arabia
saxogrammaticus	saxo
heidelberguniversity	heidelberg
importsubstitutionindustrialization	importsubstitution
virtualprivatenetwork	vpn
saureus	staphylococcusaureus
johnphilipsousa	sousa
jeffbeckgroup	thejeffbeckgroup
synthesizer	synth
cymbals	cymbal
johnchapman	johnnyappleseed
victorianarchitecture	victorian
brittleness	brittle
madhvacharya	madhva
atmosphericentry	atmosphericreentry
chiptunes	chiptune
litmustest	litmus
gratuity	tipping
forbesmagazine	forbes
donbradman	sirdonaldbradman
socialism	socialist
drifters	thedrifters
api	applicationprogramminginterface
reich	stevereich
krzysztofpenderecki	penderecki
ultimaonline	uo
jiangsuprovince	jiangsu
forumromanum	romanforum
chasemanhattanbank	chase
television	tv
augusterodin	rodin
floridastateuniversity	fsu
caledfwlch	excalibur
bostonbruins	bruins
icao	internationalcivilaviationorganization
danzig	glenndanzig
earthquake	tremor
assyrianpeople	assyrians
xinhuanewsagency	xinhua
windowsxp	xp
alexanderborodin	borodin
fantasyrecords	fantasy
maidmarian	marian
marginaltaxrate	taxrate
anginapectoris	angina
terabytes	terabyte
newscorporation	newscorp
woodwindinstrument	woodwind
jeansibelius	sibelius
vijayanagarempire	vijayanagaraempire
familyhistory	genealogy
chronicobstructivepulmonarydisease	copd
boulez	pierreboulez
adobesystems	adobe
giacomomeyerbeer	meyerbeer
thegovernmentinspector	theinspectorgeneral
centralprocessingunit	cpu
vandergraafgenerator	vandergraaf
cdc	controldatacorporation
lucianopavarotti	pavarotti
male	men
amctheatres	amc
jeanphilipperameau	rameau
harveydent	twoface
ecb	europeancentralbank
remittances	remittance
fujianprovince	fujian
antoninartaud	artaud
datastoragedevice	recordingmedium
bladder	urinarybladder
erik	thephantom
beltway	ringroad
latinalphabet	romanalphabet
episcopacy	episcopalpolity
monlanguage	mon
haydn	josephhaydn
emesa	homs
cubism	cubist
kazakhs	kazakh
melkor	morgoth
redness	red
diabetesmellitus	diabetes
audubonsociety	nationalaudubonsociety
birthcontrol	contraception
labourparty	pvda
trento	trent
hindutemple	mandir
fenderstratocaster	strat
worldsciencefictionconvention	worldcon
supremes	thesupremes
symphonicpoem	tonepoem
fredrogers	misterrogers
leukocytes	whitebloodcell
johnsoane	sirjohnsoane
glycosides	glycoside
brendan	saintbrendan
standardoilcompany	standardoil
thevampirediaries	vampirediaries
fritillaria	fritillary
livejournal	lj
franzschubert	schubert
ichirosuzuki	ichiro
countyoffaly	offaly
zebulon	zebulun
cornishlanguage	cornish
captainjamescook	jamescook
unitedpressinternational	upi
chimpanzee	chimp
taipeicity	taipei
indianapolis500	indy500
bresson	robertbresson
akmolinsk	astana
anxiolytics	anxiolytic
organicacids	organicacid
scorpio	scorpius
cohen	kohen
zulukingdom	zululand
victoria	vic
modernlibrary	themodernlibrary
azerbaijanis	azeri
virginiamilitaryinstitute	vmi
doublej	triplej
durumwheat	durum
iggypop	iggy
boatramp	slipway
homemaker	homemaking
lf	lowfrequency
doobiebrothers	thedoobiebrothers
oresteia	theoresteia
unemploymentbenefits	unemploymentbenefit
britishpeerage	peerage
aleksandrsolzhenitsyn	solzhenitsyn
instrumentalist	musician
andrewssisters	theandrewssisters
delusions	delusion
feed	webfeed
ukrainianlanguage	ukrainian
worldtradeorganization	wto
scottishpremierleague	spl
mebibyte	mib
asio	australiansecurityintelligenceorganisation
chewa	nyanja
dentistry	dentist
commissionergordon	jamesgordon
emperormeiji	meijiemperor
carlfriedrichgauss	gauss
badfinger	theiveys
belmondo	jeanpaulbelmondo
childerici	childeric
benetleilax	tleilaxu
riftvalleyprovince	riftvalley
independentfilm	indiefilm
brutus	marcusjuniusbrutus
hipfractures	hipfracture
epicrecords	epic
certifiedpublicaccountant	cpa
dramatist	playwright
antiwarmovement	antiwar
khalistanmovement	khalistan
bruise	contusion
mule	themule
dailynews	newyorkdailynews
kkr	kohlbergkravisroberts
nationalrenewableenergylaboratory	nrel
multicoreprocessor	multicore
jetpropulsionlaboratory	jpl
padova	padua
newjerseyturnpikeauthority	newjerseyturnpike
judahhalevi	yehudahalevi
lionsgateentertainment	lionsgate
lyrichammersmith	lyrictheatre
openvld	vld
craze	fad
sar	syntheticapertureradar
jamesdavis	jimdavis
maternaldeath	maternalmortality
highbloodsugar	hyperglycemia
christmasmusic	christmassong
communitycenter	communitycentre
bangles	thebangles
earl	jarl
abstractexpressionism	abstractexpressionist
phibunsongkhram	phibun
collegeboard	thecollegeboard
communicationsprotocol	protocol
federalexpress	fedex
xraycrystallography	xraydiffraction
transporthub	transportationhub
sprintcupseries	winstoncup
wordprocessing	wordprocessor
champcarworldseries	champcar
mentoring	mentorship
chiefinformationofficer	cio
gabrieli	giovannigabrieli
nam	nonalignedmovement
ufo	unidentifiedflyingobject
astrodome	houstonastrodome
michaelnyman	nyman
afcchampionshipgame	afcchampionship
cilantro	coriander
gratefuldead	thegratefuldead
lisboa	lisbon
aerialrefueling	aerialrefuelling
belgique	belgium
libertarianism	libertarian
police	thepolice
swamivivekananda	vivekananda
elizabeth	saintelizabeth
biologicalsciences	biology
surveying	surveyor
asteraceae	compositae
pulp	woodpulp
cantonesecuisine	cantonese
delfonics	thedelfonics
dubmusic	dub
ccr	creedenceclearwaterrevival
volkswagenag	volkswagengroup
devil	thedevil
livy	tituslivius
diabase	dolerite
melanesian	melanesia
negevdesert	negev
businesslaw	commerciallaw
mushroom	toadstool
decorationday	memorialday
fantasticfour	thefantasticfour
organisation	organization
westpaterson	woodlandpark
codesharing	codeshareagreement
ayatollahkhomeini	ruhollahkhomeini
missiondistrict	themission
tatramountains	tatras
pablopicasso	picasso
